tap.sagepub.com	scientific
qualitative-research.net	scientific
pe.com	news
iijournals.com	scientific
present.fr	news
rpd.unibo.it	scientific
libertyunyielding.com	fakenews
usma.edu	usgov
cbssports.com	news
e-asianwomen.org	scientific
g3journal.org	scientific
siam.org	scientific
spirula.nl	scientific
cuadernosdebiodiversidad.org	scientific
reproduction-online.org	scientific
canoe.ca	news
twi.gl	commercial
chicagotribune.com	news
cellmetabolism.org	scientific
akkrt.hu	scientific
jgeosci.org	scientific
equinoxpub.com	scientific
governor.wa.gov	usgov
commonknowledge.dukejournals.org	scientific
z-phys-chem.de	scientific
concrete5.org	blog
al-fadjr.com	news
geolmag.geoscienceworld.org	scientific
xanga.com	blog
dmv.ny.gov	usgov
aftonbladet.se	news
bbg.gov	usgov
thepoke.co.uk	fakenews
sag.sagepub.com	scientific
nnsa.doe.gov	usgov
club.japantimes.co.jp	news
youaresimplyradiant.com	commercial
ejournals.library.ualberta.ca	scientific
socom.mil	usgov
governor.maryland.gov	usgov
sankhya.isical.ac.in	scientific
oae.sagepub.com	scientific
dallasvoice.com	fakenews
praxisfilosofica.univalle.edu.co	scientific
viid.me	commercial
tellusb.net	scientific
wikidot.com	blog
her.oxfordjournals.org	scientific
nrz.de	news
almassae.press.ma	news
journals.uchicago.edu	scientific
jmg.bmj.com	scientific
jtopol.oxfordjournals.org	scientific
relat.org	scientific
mptmagazine.com	scientific
theeventchronicle.com	fakenews
vocedimantova.it	news
qz.com	news
wordpress.com	blog
ppa.sagepub.com	scientific
revistaseletronicas.pucrs.br	scientific
plos.org	scientific
copainsdavant.com	socialmedia
tosem.acm.org	scientific
cdc.gov	usgov|scientific
ejcts.oxfordjournals.org	scientific
alumniportal-deutschland.org	socialmedia
www3.nd.edu	scientific
nopr.niscair.res.in	scientific
ntr.oxfordjournals.org	scientific
clarin.com	news
myemail.constantcontact.com	commercial
giantbomb.com	news
database.oxfordjournals.org	scientific
foi.sagepub.com	scientific
pharmacotherapy.org	scientific
projecteuclid.org	scientific
lottery.ok.gov	usgov
fs.oxfordjournals.org	scientific
pharmrev.aspetjournals.org	scientific
floodsmart.gov	usgov
cad.sagepub.com	scientific
phcogcommn.org	scientific
gnu.io	blog
peoplesearch.hud.gov	usgov
usace.army.mil	usgov
spectroscopyeurope.com	scientific
dailynews.co.tz	news
ojs.lib.byu.edu	scientific
hawaiiaudubon.org	scientific
radiochimica-acta.de	scientific
sloanreview.mit.edu	scientific
nationalreport.net	fakenews
usembassy.gov	usgov
monthlyreview.org	scientific
dot.nd.gov	usgov
larazon.es	news
do.treas.gov	usgov
goarmy.com	usgov
pintrest.com	socialmedia
springerpub.com	scientific
guelphmercury.com	news
ifporient.org	scientific
comm.utoronto.ca	scientific
engadget.com	news
ri.gov	usgov
eaglehill.us	scientific
jsite.uwm.edu.pl	scientific
bipartisanreport.com	fakenews
journals.co.za	scientific
jdm.sagepub.com	scientific
t35.com	blog
activistpost.com	clickbait|fakenews
jjap.jsap.jp	scientific
thecommonsenseshow.com	fakenews
kkk.com	fakenews
la-press.com	scientific
alabama.gov	usgov
corrieredelveneto.corriere.it	news
subjectpolitics.com	fakenews
sdsos.gov	usgov
jlr.org	scientific
europolitique.info	news
dir.texas.gov	usgov
dad.boun.edu.tr	scientific
homeopathyjournal.net	scientific
lnr-dz.com	news
ustda.gov	usgov
tlainc.com	scientific
vice.com	news
hsr.org	scientific
cercor.oxfordjournals.org	scientific
nutrition.org	scientific
nanolithography.spiedigitallibrary.org	scientific
21stcenturywire.com	clickbait|fakenews
mentelocale.it	news
cpt.sagepub.com	scientific
familysecuritymatters.org	fakenews
car.sagepub.com	scientific
american-music.org	scientific
moloncol.org	scientific
avvenire.it	news
fourthriver.chatham.edu	scientific
dailytech.com	news
nowtheendbegins.com	clickbait|fakenews
cappsy.org	scientific
ita.doc.gov	usgov
enduringvision.com	fakenews
begellhouse.com	scientific
cutbankonline.org	scientific
ieee-awpl.eecs.qmul.ac.uk	scientific
lexpressiondz.com	news
pophealthmetrics.biomedcentral.com	scientific
corrections.ky.gov	usgov
joingoodbeing.com	commercial
znaturforsch.com	scientific
sport.es	news
contact-us.state.gov	usgov
library.seg.org	scientific
calgaryherald.com	news
cnbc.com	news
dailygamecock.com	news
sheepkillers.com	fakenews
mathpsych.org	scientific
vedomosti.ru	news
morningledger.com	fakenews
taz.de	news
jasn.asnjournals.org	scientific
state.wv.us	usgov
srhe.ac.uk	scientific
jekyllrb.com	blog
island.lk	news
cmos.ca	scientific
theobserver.ca	news
europeanneuropsychopharmacology.com	scientific
burrardstreetjournal.com	fakenews
grants.gov	usgov
revistadefilologiaespa√±ola.revistas.csic.es	scientific
aan.sagepub.com	scientific
livestream.com	videos
iflscience.com	blog
jocg.org	scientific
nylottery.ny.gov	usgov
seminperinat.com	scientific
ncix.gov	usgov
prf.sagepub.com	scientific
elmundo.com	news
afrjpaedsurg.org	scientific
diariodesevilla.es	news
ncbi.nlm.nih.gov	scientific
jeune-independant.net	news
metro.lu	news
conservativeoutfitters.com	clickbait|fakenews
rpd.oxfordjournals.org	scientific
soci.org	scientific
joeg.oxfordjournals.org	scientific
sciweb.nybg.org	scientific
hyper.ahajournals.org	scientific
bostonglobe.com	news
jxb.oxfordjournals.org	scientific
pressesagro.be	scientific
nrcresearchpress.com	scientific
elpuntavui.cat	news
rightwingnews.com	fakenews
stratcom.mil	usgov
beilstein-journals.org	scientific
signsjournal.org	scientific
attn.com	fakenews
info.ahrq.gov	usgov
computer.org	scientific
lalibre.be	news
bb.lv	news
uno.edu	scientific
fcs.revues.org	scientific
lmr.	fakenews
thirdtext.com	scientific
sos.oregon.gov	usgov
jci.org	scientific
amestribune.com	news
ghost.org	blog
biolsci.org	scientific
gss.omb.delaware.gov	usgov
erevistas.saber.ula.ve	scientific
sfsrfs.org	scientific
aboriginalhistory.org	scientific
rumormillnews.com	fakenews
mja.com.au	scientific
quimicanova.sbq.org.br	scientific
neurologyindia.com	scientific
english.ivpp.cas.cn	scientific
departed.co	fakenews
der-postillon.com	fakenews
sciencefromisrael.com	scientific
edq.sagepub.com	scientific
rt.com	fakenews
jcea.agr.hr	scientific
otexa.ita.doc.gov	usgov
journals.tums.ac.ir	scientific
berlinertageszeitung.com	news
current-biology.com	scientific
prst-ab.aps.org	scientific
yesimright.com	fakenews
juvenilecouncil.gov	usgov
sydsvenskan.se	news
molmed.org	scientific
ars.usda.gov	usgov
afr.com	news
minorplanet.info	scientific
wcx.sagepub.com	scientific
cronachedalmondo.com	news
journalofia.org	scientific
elections.ny.gov	usgov
www2.ametsoc.org	scientific
annali.unife.it	scientific
libertytalk.fm	clickbait|fakenews
ijact.org	scientific
dot.state.wy.us	usgov
tech.snmjournals.org	scientific
usahitman.com	fakenews
pocketgamer.co.uk	news
oneindia.com	news
ecp.ejpecp.org	scientific
lerenouveau.com.tn	news
annales.ehess.fr	scientific
tocl.acm.org	scientific
stke.sciencemag.org	scientific
jair.org	scientific
songyuan.org	scientific
self.com	news
eac.gov	usgov
kssos.org	usgov
owenwisterreview.wordpress.com	scientific
qsw.sagepub.com	scientific
circ.ahajournals.org	scientific
cms.math.ca	scientific
doc.nv.gov	usgov
bellpub.com	scientific
nuevaweb.diariocolatino.com	news
gaq.sagepub.com	scientific
crl.acrl.org	scientific
chiroandosteo.com	scientific
site.uit.no	scientific
brill.nl	scientific
pjm.math.berkeley.edu	scientific
visitnc.com	usgov
aidsonline.com	scientific
mediamass.net	fakenews
sswe.tamu.edu	scientific
hth.sagepub.com	scientific
www1.montpellier.inra.fr	scientific
monumenta.cc.sophia.ac.jp	scientific
mnvotesinfo.sos.state.mn.us	usgov
amjtrans.com	scientific
factsreports.revues.org	scientific
jcimjournal.com	scientific
thieme.com	scientific
botges.ch	scientific
techtarget.com	news
kenoradailyminerandnews.com	news
usccr.gov	usgov
atf.gov	usgov
c-span.org	news
minrec.org	scientific
unitedmediapublishing.com	fakenews
ams.org	scientific
ebar.com	fakenews
bcrme.press.illinois.edu	scientific
bordeaux7.com	news
thuto.org	scientific
deseretnews.com	news
365usanews.com	fakenews
orgsyn.org	scientific
srbc.net	usgov
tumblr.com	blog|socialmedia
revistas.unal.edu.co	scientific
delmnh.org	scientific
roller.apache.org	blog
esquire.com	news
countercurrentnews.com	fakenews
eujournal.org	scientific
worldnewsdailyreport.com	satire|fakenews
physiologyonline.physiology.org	scientific
mmvc.ms.gov	usgov
babylonbee.com	fakenews
whatreallyhappened.com	fakenews
cancercell.org	scientific
redlandsdailyfacts.com	news
mic.sgmjournals.org	scientific
sceducationlottery.com	usgov
internationalshoulderjournal.org	scientific
synapse.koreamed.org	scientific
techdirt.com	commercial
politicalreviewer.com	fakenews
bjcancer.com	scientific
india.com	news
usanewsflash.com	fakenews
ohio.gov	usgov
defenseone.com	blog
tpi.it	news
wyolotto.com	usgov
jag.sagepub.com	scientific
elkoshary.com	fakenews
uiweb.uidaho.edu	scientific
reporternews.com	news
urbanavis.dk	news
bcmj.org	scientific
spunti.com.au	scientific
smithsonianmag.com	news
outlookindia.com	news
gut.bmj.com	scientific
mnlottery.com	usgov
content.iospress.com	scientific
ahram.org.eg	news
battlecreekenquirer.com	news
fmx.sagepub.com	scientific
mplant.oxfordjournals.org	scientific
epaa.asu.edu	scientific
patdollard.com	fakenews
greenbaypressgazette.com	news
usip.org	usgov
mitpressjournals.org	scientific
70news.wordpress.com	fakenews
nmfs.noaa.gov	usgov
fampra.oupjournals.org	scientific
fmshrc.gov	usgov
clashdaily.com	fakenews
icheme.org	scientific
empirenews.com	fakenews
militarytimes.com	blog
mnras.oxfordjournals.org	scientific
armand-colin.com	scientific
humanite.fr	news
alquds.com	news
physiologicalreports.org	scientific
traffic.dk	scientific
rockymountainnews.com	news
pop.aip.org	scientific
bos.org.uk	scientific
hidot.hawaii.gov	usgov
manchestereveningnews.co.uk	news
theracketreport.com	fakenews
city-analysis.net	scientific
idahopress.com	news
jibs.net	scientific
amjmedsci.com	scientific
injuryprevention.bmj.com	scientific
trurodaily.com	news
dag.revista.uab.es	scientific
oakridge.doe.gov	usgov
ciencias.bogota.unal.edu.co	scientific
apuntesdepsicologia.es	scientific
aba.org	scientific
nordbayern.de	news
dermatology.cdlib.org	scientific
jgim.org	scientific
bep.gov	usgov
thetruthdivision.com	fakenews
science.energy.gov	usgov
fanpage.it	news
iands.org	scientific
bsu.edu	scientific
ameblo.jp	blog|socialmedia
clinical-breast-cancer.com	scientific
skeptiko.com	fakenews
healthunlocked.com	socialmedia
cief.info	scientific
cornelljournalofarchitecture.cornell.edu	scientific
hawaiitribune-herald.com	news
theskunk.org	fakenews
informapharmascience.com	scientific
frontiersinecology.org	scientific
febsjournal.org	scientific
pivotx.net	blog
bdlive.co.za	news
unclesamsmisguidedchildren.com	fakenews
jfs.tku.edu.tw	scientific
bravenet.com	blog
postregister.com	news
entsoc.org	scientific
vox.com	blog
compcytogen.pensoft.net	scientific
ijo.sagepub.com	scientific
wiley.com	scientific
secoloditalia.it	news
eps.revues.org	scientific
theblaze.com	fakenews
ifors.org	scientific
lesechos.ml	news
cdcr.ca.gov	usgov
oregonlottery.org	usgov
revue-metallurgie.org	scientific
us-cert.gov	usgov
ettelaat.com	news
leveil.fr	news
atsdr.cdc.gov	usgov
bjr.sagepub.com	scientific
doc.state.al.us	usgov
jbis.org.uk	scientific
politicot.com	fakenews
humanamente.eu	scientific
kentuckygov.desk.com	usgov
lilt.ilstu.edu	scientific
ilfoglio.it	news
journals.elsevier.com	scientific
dio.sagepub.com	scientific
ejcr.org	scientific
viralnova.com	news
focus.aps.org	scientific
scdailypress.com	news
raco.cat	scientific
whitehorsestar.com	news
supremecourtus.gov	usgov
epjournal.net	scientific
zizekstudies.org	scientific
ccforum.com	scientific
findahealthcenter.hrsa.gov	usgov
secretservice.gov	usgov
press.huc.edu	scientific
tts.sec.gov	usgov
cpa.sagepub.com	scientific
vivote.gov	usgov
gazzettadimantova.it	news
abc.es	news
periodico.ebras.bio.br	scientific
mass.gov	usgov
acu.edu	scientific
crooksandliars.com	fakenews
ard.bmj.com	scientific
voix-oranie.com	news
ijcb.org	scientific
studentaidhelp.ed.gov	usgov
ijccm.org	scientific
openchemistry.com	scientific
time.com	news
ftccomplaintassistant.gov	usgov
ilcovile.it	scientific
jpe.sagepub.com	scientific
stuttgartdailyleader.com	news
michigan.gov	usgov
politicalupdater.com	fakenews
europeanreview.org	scientific
officelive.com	blog
aufaitmaroc.com	news
gofundme.com	commercial
amphilsoc.org	scientific
springerlink.com	scientific
rmi.ge	scientific
revistadeindias.revistas.csic.es	scientific
biij.org	scientific
aapg.org	scientific
content.onlinejacc.org	scientific
jpagonline.org	scientific
google.co.uk	blog
journalofelectronicpublishing.org	scientific
iaprisonind.com	usgov
qualitysafety.bmj.com	scientific
annalsofepidemiology.org	scientific
sji.gov	usgov
asj.or.jp	scientific
mda.mil	usgov
manoramaonline.com	news
nzma.org.nz	scientific
cochrane.org	scientific
mdoc.state.ms.us	usgov
photonicsforenergy.spiedigitallibrary.org	scientific
nwfdailynews.com	news
applij.oxfordjournals.org	scientific
doc.sd.gov	usgov
cnic.navy.mil	usgov
delaware.gov	usgov
inpractice.bvapublications.com	scientific
warontherocks.com	blog
ims.cuhk.edu.hk	scientific
tr.knteu.kiev.ua	scientific
sherbrookerecord.com	news
neuron.org	scientific
molpharm.aspetjournals.org	scientific
psyche.entclub.org	scientific
sketch-life.jp	socialmedia
ilsecoloxix.it	news
oge.gov	usgov
gohawaii.com	usgov
printly.net	fakenews
ijpn.ir	scientific
pshares.org	scientific
ajhp.org	scientific
electronicimaging.spiedigitallibrary.org	scientific
sandiegoshellclub.com	scientific
jhs.oxfordjournals.org	scientific
bluenationreview.com	fakenews
albayane.press.ma	news
forctr.com	blog
landoverbaptist.org	fakenews
horizonpress.com	scientific
my.mail.ru	socialmedia
qhr.sagepub.com	scientific
opic.gov	usgov
dailybulletin.ca	news
triquarterly.org	scientific
epm.sagepub.com	scientific
chaser.com.au	fakenews
revistes.ub.edu	scientific
saisreview.org	scientific
pamelageller.com	fakenews
chungara.cl	scientific
gos.sagepub.com	scientific
sea-entomologia.org	scientific
logcom.oxfordjournals.org	scientific
radiology.rsna.org	scientific
cmstudies.org	scientific
fognews.ru	fakenews
admongo.gov	usgov
jim.sagepub.com	scientific
autismspeaks.org	scientific
well.blogs.nytimes.com	news
physicstoday.org	scientific
jimdo.com	blog
telligent.com	blog
editions.bnf.fr	scientific
eng.sagepub.com	scientific
jpepsy.oxfordjournals.org	scientific
stratfordbeaconherald.com	news
gulfpetrolink.com	scientific
freundpublishing.com	scientific
ptep-online.com	scientific
nishinippon.co.jp	news
hqdainet.army.mil	usgov
jth.sagepub.com	scientific
aequatoria.be	scientific
jisppd.com	scientific
piirus.com	socialmedia
eu.wiley.com	scientific
juventudrebelde.cu	news
assafir.com	news
ilfattoquotidiano.it	news
informationweek.com	news
deals.ebay.com	commercial
elprofesionaldelainformacion.com	scientific
uwpress.wisc.edu	scientific
nc.gov	usgov
bnn.de	news
nigc.gov	usgov
uscourts.cavc.gov	usgov
thecontroversialfiles.net	fakenews
princegeorgecitizen.com	news
sf.oxfordjournals.org	scientific
academia.edu	socialmedia
mcr.sagepub.com	scientific
journalofcosmology.com	scientific
npar.ru	scientific
ujp.bitp.kiev.ua	scientific
revues.armand-colin.com	scientific
twitchy.com	fakenews
dms.sagepub.com	scientific
dose.ca	news
doc.gov	usgov
phcogrev.com	scientific
psr.sagepub.com	scientific
jacm.acm.org	scientific
plh.univ-tlse2.fr	scientific
ardeola.org	scientific
fortunecity.com	blog
thepress.purdue.edu	scientific
articulo.revues.org	scientific
alsic.revues.org	scientific
scv.sagepub.com	scientific
circres.ahajournals.org	scientific
chemeducator.org	scientific
state.nj.us	usgov
dailystormer.com	fakenews
dmv.dc.gov	usgov
diabetes.diabetesjournals.org	scientific
arkansas.gov	usgov
pakalertpress.com	clickbait|fakenews
estudiosdeasiayafrica.colmex.mx	scientific
rga.revues.org	scientific
rheumatology.oupjournals.org	scientific
speld.nl	fakenews
othervoices.org	scientific
brookings.edu	scientific
fpri.org	scientific
dodiis.mil	usgov
wih.sagepub.com	scientific
1stcenturywire.com	fakenews
reforma.com	news
pap.es	scientific
intl.clinchem.org	scientific
cms.hhs.gov	usgov
eaq.sagepub.com	scientific
archotol.ama-assn.org	scientific
mankindquarterly.com	scientific
ivi.sagepub.com	scientific
jtlu.org	scientific
ideasyvalores.unal.edu.co	scientific
apsanet.org	scientific
la-croix.com	news
colpos.mx	scientific
viviti.com	blog
paternosterperiodicals.co.uk	scientific
scielo.sld.cu	scientific
lsc.gov	usgov
wirtschaftsdienst.eu	scientific
critiquejournal.net	scientific
home.twibble.io	commercial
myspace.com	socialmedia
ajol.info	scientific
jbc.sagepub.com	scientific
aspt.net	scientific
djoef-forlag.dk	scientific
epilepticdisorders.com	scientific
visitnh.gov	usgov
hrd.sagepub.com	scientific
vaildaily.com	news
ers.usda.gov	usgov
letemps.ch	news
webdaily.com	fakenews
ilpost.it	news
good.is	news
extrapolation.liverpooluniversitypress.co.uk	scientific
usaid.gov	usgov
ispan.waw.pl	scientific
rss.nytimes.com	news
icr.uexternado.edu.co	scientific
hjmed.org	scientific
voce.com.ve	news
texas.gov	usgov
rfg.revuesonline.com	scientific
heb.sagepub.com	scientific
norois.revues.org	scientific
cancerres.aacrjournals.org	scientific
gsa.gov	usgov
oilgeopolitics.net	fakenews
depts.washington.edu	scientific
mbl.is	news
tme.coe.uga.edu	scientific
usunnewyork.usmission.gov	usgov
missourireview.com	scientific
jtd.sagepub.com	scientific
jac.oxfordjournals.org	scientific
ewh.ieee.org	scientific
data.gouv.fr	socialmedia
bigamericannews.com	fakenews
winetitles.com.au	scientific
ant.sagepub.com	scientific
cmb.ac.lk	scientific
tageswoche.ch	news
smallbiztrends.com	blog
tos.org	scientific
prescrire.org	scientific
europeanjournaloftaxonomy.eu	scientific
online.jkmesh.com	blog
perlinguam.journals.ac.za	scientific
sih.sagepub.com	scientific
stuttgarter-nachrichten.de	news
viralliberty.com	fakenews
traveltex.com	usgov
aol.com	commercial
federallabs.org	usgov
cla.purdue.edu	scientific
cameroon-tribune.cm	news
sourcefabric.org	blog
saao.ac.za	scientific
newsthump.com	fakenews
portlanddailysun.me	news
academicjournals.org	scientific
cejiss.org	scientific
ellecanada.com	news
scotsman.com	news
directmatin.fr	news
thehindubusinessline.com	news
jamesmadison.gov	usgov
patch.com	blog
elnervion.com	news
journalofmas.com	scientific
metropolisweb.it	news
jep.sagepub.com	scientific
riifr.univ-littoral.fr	scientific
elifesciences.org	scientific
jlo.sagepub.com	scientific
mfdnes.cz	news
gather.com	blog
horizons-dz.com	news
idunn.no	scientific
lexblog.com	news
calyxpress.org	scientific
thelibertybeacon.com	fakenews
ajm.sagepub.com	scientific
worldneurosurgery.org	scientific
amardeshonline.com	news
rockcitytimes.com	satire|fakenews
enim-egyptologie.fr	scientific
nyas.org	scientific
dmv.state.pa.us	usgov
manchesteruniversitypress.co.uk	scientific
earth-planets-space.com	scientific
ema.sagepub.com	scientific
berlingske.dk	news
molvis.org	scientific
newsmutiny.com	fakenews
djmt.nl	scientific
republicain-lorrain.fr	news
jonkopingsposten.se	news
votingmatters.org.uk	scientific
landscaperesearch.livingreviews.org	scientific
state.gov	usgov
dailystar.co.uk	news
foa.sagepub.com	scientific
cin.sagepub.com	scientific
wvlottery.com	usgov
gmt.sagepub.com	scientific
biohorizons.oxfordjournals.org	scientific
laprovincia.it	news
usitc.gov	usgov
instaar.colorado.edu	scientific
complex.com	scientific
thingamablog.com	blog
tokyo-np.co.jp	news
imh.org.rs	scientific
science.smith.edu	scientific
confrontationmagazine.org	scientific
dawn.com	news
sdos.ejournal.ascc.net	scientific
jic.org.tw	scientific
mba.ac.uk	scientific
jei.sagepub.com	scientific
nhic.org	usgov
au.wiley.com	scientific
prd.aps.org	scientific
neotropicalbirdclub.org	scientific
ijcm.org.in	scientific
fcg.gov	usgov
synthasite.com	blog
nmlottery.com	usgov
faculty.fordham.edu	scientific
arxiv.org	scientific
courant.com	news
mikroglottika.com	scientific
berliner-zeitung.de	news
dnaindia.com	news
connectjournals.com	scientific
onlineconservativepress.com	fakenews
yale.edu	scientific
ajl.sagepub.com	scientific
jsn.sagepub.com	scientific
vba.va.gov	usgov
truman.gov	usgov
yournewswire.com	fakenews
insider.foxnews.com	news
publicaciones.uva.es	scientific
prx.aps.org	scientific
ccms.ukzn.ac.za	scientific
worldscinet.com	scientific
ini.sagepub.com	scientific
dailysignal.com	news
vermont.gov	usgov
traildailytimes.ca	news
ijpor.oxfordjournals.org	scientific
pacom.mil	usgov
oldwww.just.edu.jo	scientific
histoire-politique.fr	scientific
fossil-record.net	scientific
romancestudies.cornell.edu	scientific
saj.matf.bg.ac.rs	scientific
renditions.org	scientific
ga-online.de	news
collegian.psu.edu	news
tva.sagepub.com	scientific
stuppid.com	fakenews
thefreethoughtproject.com	fakenews
bjs.co.uk	scientific
lawfareblog.com	blog
dtra.mil	usgov
wvupressonline.com	scientific
supernowosci24.pl	news
visitidaho.org	usgov
organicandhealthy.org	blog
alaskahighwaynews.ca	news
worldscientific.com	scientific
tobaccocontrol.bmj.com	scientific
americanoverlook.com	fakenews
owler.com	commercial
pressesdesciencespo.fr	scientific
pjps.pk	scientific
dianoia.filosoficas.unam.mx	scientific
jenonline.org	scientific
gamesradar.com	news
politicops.com	fakenews
swjggc.com	scientific
journals.iucr.org	scientific
sciencedaily.com	news
aaanet.org	scientific
psi.sagepub.com	scientific
webcitation.org	scientific
peacecorps.gov	usgov
kirj.ee	scientific
entekhab.ir	news
agefi.ch	news
theepochtimes.com	news
scientificexploration.org	scientific
chbeck.de	scientific
traveloregon.com	usgov
tractionsoftware.com	blog
jme.bmj.com	scientific
inmabb.criba.edu.ar	scientific
agupubs.onlinelibrary.wiley.com	scientific
mmj.sagepub.com	scientific
humrep.oxfordjournals.org	scientific
multiply.com	blog
npjournal.org	scientific
etudesafricaines.revues.org	scientific
codesria.org	scientific
bigpzone.com	clickbait|fakenews
thestar.com.my	news
publicaciones.unirioja.es	scientific
nanolabweb.com	scientific
dot.ca.gov	usgov
alabama.travel	usgov
fmcs.gov	usgov
sbf.c.se	scientific
lucas.leeds.ac.uk	scientific
rsx.sagepub.com	scientific
uia.no	scientific
conservativepapers.com	fakenews
jaacap.com	scientific
njas.helsinki.fi	scientific
fec.gov	usgov
benthamscience.com	scientific
lesoftonline.net	news
credoaction.com	commercial
jcn.sagepub.com	scientific
bmv.ohio.gov	usgov
phy.duke.edu	scientific
themusicaltimes.blogspot.com	scientific
bolivianchemistryjournal.org	scientific
arjournals.annualreviews.org	scientific
fty.sagepub.com	scientific
campaignsandelections.com	scientific
rcpe.ac.uk	scientific
fca.gov	usgov
landbote.ch	news
quotidianodipuglia.it	news
casesjournal.com	scientific
rstb.royalsocietypublishing.org	scientific
gpo.gov	usgov
indianjmedsci.org	scientific
istl.org	scientific
webmd.com	blog
elsevier.com	scientific
amm.shu.edu.cn	scientific
dmm.biologists.org	scientific
fvap.gov	usgov
ocala.com	news
last.fm	socialmedia
jpcrd.aip.org	scientific
rutlandherald.com	news
jcp.or.jp	news
ton.seas.upenn.edu	scientific
admin.ks.gov	usgov
jgv.sgmjournals.org	scientific
nar.oxfordjournals.org	scientific
weeklyworldnews.com	satire|fakenews
si.edu	usgov
analysis.oxfordjournals.org	scientific
remmm.revues.org	scientific
publico.pt	news
digitalcommons.mcmaster.ca	scientific
witscience.org	fakenews
utpjournals.com	scientific
bjmp.org	scientific
bpb.pharm.or.jp	scientific
ketchikandailynews.com	news
nationalinsiderpolitics.com	fakenews
minorityhealth.hhs.gov	usgov
azstarnet.com	news
aisle.aisnet.org	scientific
healthaffairs.org	scientific
neurology.org	scientific
logika.uwb.edu.pl	scientific
sportsnet.ca	news
acsj.info	scientific
calottery.com	usgov
carlisle.army.mil	scientific
vip.sos.nd.gov	usgov
stats.bls.gov	usgov
fhfa.gov	usgov
floridareview.cah.ucf.edu	scientific
biomet.oupjournals.org	scientific
allchemy.iq.usp.br	scientific
nebraskapress.unl.edu	scientific
lemouvementsocial.net	scientific
ucpressjournals.com	scientific
terrain.org	scientific
npr.org	news
naturalhealth365.com	blog
unita.it	news
psupress.org	scientific
mdpi.com	scientific
sigmobile.org	scientific
doleta.gov	usgov
ppg.sagepub.com	scientific
online.liverpooluniversitypress.co.uk	scientific
mail.house.gov	usgov
kronika.ro	news
www2.pr.gov	usgov
governor.hawaii.gov	usgov
usuncut.com	fakenews
lineaquotidiano.net	news
reginfo.gov	usgov
journalchiroed.com	scientific
armfor.uscourts.gov	usgov
ortegaygasset.edu	scientific
plosgenetics.org	scientific
precedings.nature.com	scientific
psychservices.psychiatryonline.org	scientific
benning.army.mil	scientific
entomol.org	scientific
newletters.org	scientific
kernos.ulg.ac.be	scientific
edublogs.org	blog
phg.sagepub.com	scientific
irishtimes.com	news
revue-economique.fr	scientific
lfpress.com	news
tnp.sg	news
stneotscitizen.com	fakenews
scinexx.de	scientific
booksandjournals.brillonline.com	scientific
alternativemediasyndicate.com	fakenews
prescott.edu	scientific
mva.maryland.gov	usgov
opm.gov	usgov
opuscula.agh.edu.pl	scientific
jaoa.org	scientific
ardea.nou.nu	scientific
ras.sagepub.com	scientific
advmat.de	scientific
hip.sagepub.com	scientific
news.com.au	news
webs.com	blog
sciencealert.com	blog
thehastingscenter.org	scientific
revista-hc.com	scientific
journal.cpha.ca	scientific
thechattahoocheereview.gpc.edu	scientific
jnccn.org	scientific
griffithreview.com	scientific
en.wikiversity.org	scientific
ntia.doc.gov	usgov
newschool.edu	scientific
jce.divched.org	scientific
virakesari.lk	news
volume.revues.org	scientific
jfm.sagepub.com	scientific
ignet.gov	usgov
ips.2-d.jp	scientific
miiz.waw.pl	scientific
rferl.org	usgov
lanacion.cl	news
exoticpetmedicine.com	scientific
acf.hhs.gov	usgov
americasfreedomfighters.com	fakenews
tsa.gov	usgov
nass.oxfordjournals.org	scientific
100percentfedup.com	fakenews
sbnation.com	news
biolbull.org	scientific
journals.humankinetics.com	scientific
tra.sagepub.com	scientific
lessentiel.lu	news
gh.oxfordjournals.org	scientific
eos.org	scientific
monist.buffalo.edu	scientific
washingtonpost.com	news
jidc.org	scientific
evi.sagepub.com	scientific
tmstudies.net	scientific
cheapassgamer.com	news
educatejournal.org	scientific
banglajol.info	scientific
perspectivesofnewmusic.org	scientific
apalacheereview.org	scientific
canadianbusiness.com	news
ajh.sagepub.com	scientific
bsee.gov	usgov
paris-normandie.fr	news
caravanmagazine.in	news
africaneconomicoutlook.org	scientific
bulletinofinsectology.org	scientific
jetp.ac.ru	scientific
jcs.oxfordjournals.org	scientific
intarchmed.com	scientific
cao.gov	usgov
plasreconsurg.com	scientific
clarku.edu	scientific
le.ac.uk	scientific
sciencedirect.com	scientific
ebmh.bmj.com	scientific
afraf.oxfordjournals.org	scientific
jid.sagepub.com	scientific
doc.sc.gov	usgov
ecoscience.ulaval.ca	scientific
iovs.org	scientific
revistas.uned.es	scientific
jvi.asm.org	scientific
bz-berlin.de	news
publications.ossrea.net	scientific
nzasia.org.nz	scientific
protectyourmove.gov	usgov
mlq.sagepub.com	scientific
mis.sagepub.com	scientific
usc.es	scientific
molottery.com	usgov
biomedicaloptics.spiedigitallibrary.org	scientific
phl.sagepub.com	scientific
jfs.sagepub.com	scientific
status.net	blog
pediatricobesity.net	scientific
imstat.org	scientific
dfa.ms.gov	usgov
corrections.nebraska.gov	usgov
jnci.oxfordjournals.org	scientific
radio-canada.ca	news
scielo.br	scientific
bioinformatics.oxfordjournals.org	scientific
cefi.ca	news
sify.com	news
viensuhoc.vass.gov.vn	scientific
sc.gov	usgov
jleukbio.org	scientific
hjnews.com	news
sfgate.com	news
vmj.sagepub.com	scientific
suicidepreventionlifeline.org	usgov
revistademetalurgia.revistas.csic.es	scientific
mississippilotteryresults.org	usgov
wichita.edu	scientific
etc.se	news
bet.com	news
news-journalonline.com	news
sec.state.ma.us	usgov
cghjournal.org	scientific
crossings.tcd.ie	scientific
laineygossip.com	news
frontiersin.org	scientific
ecti.pennpress.org	scientific
thinkingmomsrevolution.com	blog
sciencedomain.org	scientific
jpcs.iop.org	scientific
usun.state.gov	usgov
ijism.ricest.ac.ir	scientific
orm.sagepub.com	scientific
jph.sagepub.com	scientific
axs.com	commercial
scoop.it	commercial
records.sigmm.ndlab.net	scientific
msnbc.com	news
sos.state.oh.us	usgov
charentelibre.com	news
jisponline.com	scientific
libertywritersnews.com	fakenews
superieur.deboeck.com	scientific
tms.org	scientific
oanow.com	news
oldham-chronicle.co.uk	news
today.com	blog
prl.aps.org	scientific
hdl.handle.net	scientific
nara.gov	usgov
das.ct.gov	usgov
rsob.royalsocietypublishing.org	scientific
bap-journal.org	scientific
beheco.oxfordjournals.org	scientific
eds.org.rs	scientific
mises.org	scientific
puf.com	scientific
gazzettadasti.it	news
jiad.org	scientific
deccanherald.com	news
dor.sd.gov	usgov
gadsdentimes.com	news
cactusexplorers.org.uk	scientific
ncpc.gov	usgov
fletc.gov	usgov
arkansasonline.com	news
kingmandailyminer.com	news
dainikbhaskargroup.com	news
americorps.gov	usgov
iss.sagepub.com	scientific
paper.li	blog
luventicus.org	scientific
africapresse.com	news
jacobinmag.com	fakenews
cbo.gov	usgov
post-gazette.com	news
marketing-mba.ru	scientific
bwr.ua.edu	scientific
denverguardian.com	fakenews
ning.com	blog|socialmedia
cms.skidmore.edu	scientific
mdt.mt.gov	usgov
imj.ie	scientific
af.mil	usgov
ijfs.usb.ac.ir	scientific
justsecurity.org	blog
hunter.cuny.edu	scientific
bizpacreview.com	fakenews
eluniversal.com.mx	news
terrain.revues.org	scientific
gipsa.usda.gov	usgov
protein.bio.msu.su	scientific
biomedres.info	scientific
clinical-laboratory.de	scientific
prc.gov	usgov
mapress.com	scientific
psychologyinrussia.com	scientific
brain.oxfordjournals.org	scientific
surplus.sc.gov	usgov
denverquarterly.com	scientific
postach.io	blog
ncfs-journal.org	scientific
tcc.export.gov	usgov
cincinnati.com	news
prensalibre.com	news
aatsp.org	scientific
ilaword.org	scientific
sos.state.tx.us	usgov
phcogres.com	scientific
talg.acm.org	scientific
revistafilosofia.uchile.cl	scientific
e-revistas.uc3m.es	scientific
leonardo.info	scientific
nbcnews.com	news
jfi.sagepub.com	scientific
navy.mil	usgov
bio.kuleuven.be	scientific
isko.org	scientific
isr.journal.informs.org	scientific
anakarder.com	scientific
loc.gov	usgov
pbq.drexel.edu	scientific
ichf.edu.pl	scientific
lastampa.it	news
zavoddbk.org	scientific
psyjournals.ru	scientific
physicsessays.org	scientific
leo.cineca.it	scientific
infinite-sushi.com	blog
idaholottery.com	usgov
nvsos.gov	usgov
ijri.org	scientific
tweetedtimes.com	commercial
fq.math.ca	scientific
fbs.org.au	scientific
now8news.com	fakenews
journalofrheology.org	scientific
ln-medienhaus.de	news
wes.sagepub.com	scientific
rsa.revues.org	scientific
exphem.org	scientific
intimm.oupjournals.org	scientific
constitution.com	blog
ijb.sagepub.com	scientific
lavozdeasturias.es	news
newjournal.kcsnet.or.kr	scientific
journalofanimalscience.org	scientific
bts.gov	usgov
jgm.sagepub.com	scientific
doc.delaware.gov	usgov
pediatric.theclinics.com	scientific
entrecord.com	scientific
ntik.dk	scientific
plag.com	socialmedia
dujs.dartmouth.edu	scientific
front.moveon.org	fakenews
amplifyingglass.com	satire|fakenews
asport.fr	news
heartjnl.com	scientific
ksta.de	news
najms.org	scientific
historisktidsskrift.dk	scientific
ctvnews.ca	news
satiratribune.com	fakenews
fsis.usda.gov	usgov
guamag.org	usgov
thespec.com	news
jmptonline.org	scientific
tsa-algerie.com	news
agi.ac.za	scientific
nol.hu	news
psroc.phys.ntu.edu.tw	scientific
reru.gretha.u-bordeaux4.fr	scientific
nutritionjrnl.com	scientific
livejournal.com	blog|socialmedia
globalizationandhealth.com	scientific
fridaymash.com	fakenews
revues-gallia.cnrs.fr	scientific
avantionline.it	news
metroland.com	news
currents.plos.org	scientific
thesudburystar.com	news
cahiersagricultures.fr	scientific
fsa.usda.gov	usgov
pulsus.com	scientific
metrohk.com.hk	news
nzcps.co.nz	scientific
txdmv.gov	usgov
destructoid.com	news
qpolitical.com	fakenews
ufj.ho.ua	scientific
bookstore.gpo.gov	usgov
republikein.com.na	news
colorado.edu	scientific
menshealth.com	news
doc.louisiana.gov	usgov
amsciepub.com	scientific
lesdepechesdebrazzaville.fr	news
geologi.no	scientific
teof.uni-lj.si	scientific
corbettreport.com	fakenews
cjr.org	scientific
rogavis.no	news
filosofia.unimi.it	scientific
nouvelliste.ch	news
torreybotanical.org	scientific
raritanquarterly.rutgers.edu	scientific
mhsi.ie	scientific
sitkasentinel.com	news
dnews.eu	news
elcorreo.com	news
fcc.gov	usgov
neuroreport.com	scientific
pakbs.org	scientific
src-online.ca	scientific
rendiconti.math.unipd.it	scientific
yec.sagepub.com	scientific
msx.sagepub.com	scientific
canoe.com	news
jet.arts.cornell.edu	scientific
si.com	news
socialtextjournal.org	scientific
emro.who.int	scientific
maik.rssi.ru	scientific
hokkaido-np.co.jp	news
palaugov.org	usgov
yahoo.com	news
dailyoccupation.com	fakenews
cosmo-mg.mcgill.ca	scientific
mie.sagepub.com	scientific
jmm.sagepub.com	scientific
jgp.sagepub.com	scientific
highereducationreview.com	scientific
bentspud.com	fakenews
circleofdocs.com	blog
communio-icr.com	scientific
24sata.rs	news
illinoislottery.com	usgov
lanuovaferrara.gelocal.it	news
kslottery.com	usgov
corrieredisiena.it	news
thedailybeast.com	fakenews
ajevonline.org	scientific
theneurologist.org	scientific
acsm.revuesonline.com	scientific
lanotizia.ch	news
lequotidien.tn	news
rizospastis.gr	news
lefinancier-dz.com	news
pbs.org	videos
eurjmedres.com	scientific
jamahir.alwehda.gov.sy	news
ijhg.com	scientific
toxsci.oxfordjournals.org	scientific
rienner.com	scientific
dailycollegian.com	news
lpr-journal.org	scientific
anonnews.co	fakenews
thenewday.co.uk	news
aeq.sagepub.com	scientific
pwm.sagepub.com	scientific
lasa.international.pitt.edu	scientific
thesun.co.uk	news
eric.ed.gov	usgov
em-consulte.com	scientific
ub.es	scientific
estudioshumanisticos.org	scientific
astroscu.unam.mx	scientific
aje.sagepub.com	scientific
prairieschooner.unl.edu	scientific
commercialappeal.com	news
tcp.sagepub.com	scientific
www2.illinois.gov	usgov
khn.org	news
thepoliticalinsider.com	fakenews
opinione.it	news
jsd.sagepub.com	scientific
abcnews.com.co	fakenews
bcq.sagepub.com	scientific
e-journal.biologi.lipi.go.id	scientific
jiaps.com	scientific
newhavenreview.com	scientific
geiselmed.dartmouth.edu	scientific
vk.se	news
stores.ebay.com	commercial
react365.com	fakenews
elpais.com	news
traveliowa.com	usgov
az.com.na	news
nor-miltids.com	scientific
eplasty.com	scientific
gd.se	news
nbc-news.net	fakenews
journal-advocate.com	news
www-english.tamu.edu	scientific
vasarhelyihirlap.ro	news
clinical-colorectal-cancer.com	scientific
callaloo.tamu.edu	scientific
southwalesargus.co.uk	news
jvc.sagepub.com	scientific
materiologiques.com	scientific
avaz.ba	news
nursingmanagement.rcnpublishing.co.uk	scientific
gcq.sagepub.com	scientific
vkrugudruzei.ru	socialmedia
arabicedition.nature.com	scientific
brn.sagepub.com	scientific
jgs.geoscienceworld.org	scientific
jsonline.com	news
jnm.snmjournals.org	scientific
ijoy.org.in	scientific
ajo.com	scientific
mingaonline.uach.cl	scientific
observer.com	news
rfp.revues.org	scientific
teamat.oxfordjournals.org	scientific
int-res.com	scientific
bji.sagepub.com	scientific
scriptageologica.nl	scientific
epj.org	scientific
cdq.sagepub.com	scientific
ncsbe.gov	usgov
pz-news.de	news
arthritis-research.biomedcentral.com	scientific
pharmazie.govi.de	scientific
ijpmonline.org	scientific
phmsa.dot.gov	usgov
bgs.vermont.gov	usgov
foxnews.com	news
habariproject.org	blog
live.com	blog
jcd.org.in	scientific
spi.sagepub.com	scientific
academypublisher.com	scientific
laskyaesthetics.com	commercial
nationaljournal.com	news
twitter.com	twitter|socialmedia
rma.usda.gov	usgov
libertymovementradio.com	clickbait|fakenews
politicsandthelifesciences.org	scientific
michiganquarterlyreview.com	scientific
goneleft.com	fakenews
apa.org	scientific
annalsafrmed.org	scientific
ijdvl.com	scientific
osoyoostimes.com	news
scmagazine.com	news
journalmtm.com	scientific
sjp.sagepub.com	scientific
ansti.org	scientific
michigan.org	usgov
doa.la.gov	usgov
calgarysun.com	news
oeaw.ac.at	scientific
ojs.ub.uni-konstanz.de	scientific
brandonsun.com	news
galottery.com	usgov
tec.sagepub.com	scientific
harmreductionjournal.com	scientific
colorado.com	usgov
wikispaces.com	blog
newsmax.com	news
carleton.ca	scientific
theverge.com	news
breakingnews.com	news
asj.sagepub.com	scientific
nbc.gov	usgov
truthinmedia.com	blog
journals.cambridge.org	scientific
fletcher.tufts.edu	scientific
secure.medicalletter.org	scientific
care.diabetesjournals.org	scientific
plosbiology.org	scientific
jwsr.org	scientific
dhpregie.com	scientific
cpcjournal.org	scientific
jhered.oxfordjournals.org	scientific
ahtribune.com	fakenews
thoracic.org	scientific
lematinhaiti.com	news
technorhetoric.net	scientific
ajp.aapt.org	scientific
politico.com	news
musiccanada.com	news
jla.sagepub.com	scientific
forecasters.org	scientific
knoxnews.com	news
ieee.org	scientific
slideshare.com	blog
ilnuovocorriere.it	news
restud.com	scientific
alternative.ac.nz	scientific
bookmooch.com	socialmedia
mspb.gov	usgov
dandygoat.com	fakenews
bulletindepsychologie.net	scientific
diasporafoundation.org	socialmedia
insects.demon.co.uk	scientific
carnegiemnh.org	scientific
glamour.com	news
drudgereport.com.co	fakenews
rso.cornell.edu	scientific
jpbsonline.org	scientific
tropicultura.org	scientific
arctic.ucalgary.ca	scientific
jhv.sagepub.com	scientific
ebx.sagepub.com	scientific
gom.sagepub.com	scientific
ijl.sagepub.com	scientific
internationalbulletin.org	scientific
historiaagraria.com	scientific
thewesternstar.com	news
faz.net	news
ub.edu	scientific
nelottery.com	usgov
derpatriot.com	news
lungindia.com	scientific
abovetopsecret.com	fakenews
osmre.gov	usgov
rje.org	scientific
simcoereformer.ca	news
selloeditorial.udec.cl	scientific
revue-de-synthese.eu	scientific
sbjchem.he.com.br	scientific
deutscherkunstverlag.de	scientific
zaman.com.tr	news
rfa.org	usgov
asu.edu	scientific
conservativefiringline.com	fakenews
thedailywtf.com	fakenews
mrconservative.com	fakenews
impactjournals.com	scientific
biochemsoctrans.org	scientific
hjms.hacettepe.edu.tr	scientific
punkt.ch	news
act.credoaction.com	commercial
juneauempire.com	news
kansas.gov	usgov
theglobeandmail.com	news
nowthisnews.com	fakenews
ehu.eus	scientific
glq.dukejournals.org	scientific
iopscience.org	scientific
rss.cnn.com	news
fc2.com	blog
alternet.org	fakenews
aja.asha.org	scientific
idoc.idaho.gov	usgov
indianjnephrol.org	scientific
pjmedia.com	blog
sf-foundation.org	scientific
animal-journal.eu	scientific
csmonitor.com	news
lottery.sd.gov	usgov
mutations-online.info	news
jcp.bmjjournals.com	scientific
cialc.unam.mx	scientific
ohiolottery.com	usgov
tagesanzeiger.ch	news
seaway.dot.gov	usgov
review.antiochcollege.org	scientific
jes.sagepub.com	scientific
asp.eurasipjournals.com	scientific
cio.gov	usgov
rmcg.unam.mx	scientific
doc.wi.gov	usgov
chance.amstat.org	scientific
myarkansaslottery.com	usgov
dmtcs.org	scientific
canonlaw.cua.edu	scientific
us.geosnews.com	news
standartnews.com	news
hk.humankinetics.com	scientific
cyberdriveillinois.com	usgov
nationaalherbarium.nl	scientific
mdlottery.com	usgov
languageacquisition.org	scientific
thefederalistpapers.org	fakenews
jcs.biologists.org	scientific
atmospheric-chemistry-and-physics.net	scientific
commondreams.org	fakenews
thetimesnews.com	news
ihaf.qc.ca	scientific
sjs.sagepub.com	scientific
nashvillecitypaper.com	news
ctr.sagepub.com	scientific
omicsonline.org	scientific
fs.fed.us	usgov
thewhig.com	news
igi-global.com	scientific
demorgen.be	news
jgc301.com	scientific
saferproducts.gov	usgov
aappublications.org	scientific
secure.pdcnet.org	scientific
ifyouonlynews.com	fakenews
dcgazette.com	fakenews
fda.gov	usgov
dma.ens.fr	scientific
consumer.discoverohio.com	usgov
das.sagepub.com	scientific
journalofappliedecology.org	scientific
ni-u.edu	usgov
nrc.uscg.mil	usgov
conchasbrasil.org.br	scientific
red-sweater.com	blog
cafc.uscourts.gov	usgov
dor.mo.gov	usgov
itbusiness.ca	news
csrees.usda.gov	usgov
rel.sagepub.com	scientific
census.gov	usgov
www3.interscience.wiley.com	scientific
granma.cu	news
t-ad.net	scientific
dagsavisen.no	news
startribune.com	news
bild.de	news
scrappleface.com	fakenews
andjrnl.org	scientific
quotidiano.net	news
empireherald.com	fakenews
satakunnankansa.fi	news
news-hound.com	fakenews
patriotupdate.com	fakenews
finance.ky.gov	usgov
pa.oxfordjournals.org	scientific
quaibranly.fr	scientific
ustr.gov	usgov
humortimes.com	fakenews
sandiegouniontribune.com	news
ptice.si	scientific
asq.sagepub.com	scientific
midilibre.fr	news
ajpcon.physiology.org	scientific
crd.sagepub.com	scientific
marines.mil	usgov
nhtsa.dot.gov	usgov
pcauthority.com.au	news
cnn.com	news
nzz.ch	news
palottery.state.pa.us	usgov
nytimes.com	news
buddypress.org	blog
laprovinciapavese.repubblica.it	news
pus.sagepub.com	scientific
odiogo.com	blog
in.gov	usgov
iltempo.it	news
greatlakes-seaway.com	usgov
nej.sagepub.com	scientific
jss.sagepub.com	scientific
libertyblitzkrieg.com	fakenews
nhm.ac.uk	scientific
jmm.sgmjournals.org	scientific
mayor.dc.gov	usgov
health.gov	usgov
boulevardmagazine.org	scientific
briarcliff.edu	scientific
scfbm.org	scientific
vevo.com	videos
cpjournal.ca	scientific
insidenova.com	news
wv.gov	usgov
bips.ac.uk	scientific
iaee.org	scientific
aoa.acl.gov	usgov
ign.com	news
cpl.iphy.ac.cn	scientific
audiology.org	scientific
ebaf.edu	scientific
travelnevada.com	usgov
chretienssocietes.revues.org	scientific
fitness.gov	usgov
clicanoo.re	news
lavoixdunord.fr	news
revistas.unam.mx	scientific
uncpress.unc.edu	scientific
ch.revues.org	scientific
knowyouroptions.com	usgov
nsa.gov	usgov
csc.kth.se	scientific
ijmsn.ir	scientific
leprogres.fr	news
weaselzippers.us	blog
publish.csiro.au	scientific
wired.com	news
iss.co.za	scientific
drc.ohio.gov	usgov
jme.endocrinology-journals.org	scientific
benjamins.com	scientific
anzshm.org.au	scientific
greanvillepost.com	fakenews
jove.com	scientific
enjoyillinois.com	usgov
nacion.com	news
nutritionj.com	scientific
corrieremercantile.it	news
readfulapp.com	commercial
journalofvision.org	scientific
ria.ie	scientific
neues-deutschland.de	news
nebraska.gov	usgov
ifl.sagepub.com	scientific
adc.bmj.com	scientific
visitindiana.com	usgov
transportation.ky.gov	usgov
pitt.edu	scientific
scan.oxfordjournals.org	scientific
geoengineeringwatch.org	clickbait|fakenews
ottopagine.it	news
anneeepigraphique.msh-paris.fr	scientific
nst.com.my	news
osti.gov	usgov
militaryinstallations.dod.mil	usgov
chp.sagepub.com	scientific
annaharonline.com	news
rense.com	fakenews
emf.sagepub.com	scientific
waterfordwhispersnews.com	fakenews
hut.sagepub.com	scientific
onguardonline.gov	usgov
huffingtonpost.com	news
sls.sagepub.com	scientific
overblog.com	blog
andeangeology.cl	scientific
assassinationscience.com	fakenews
humanaffairs.sk	scientific
redrocktribune.com	fakenews
hk.apple.nextmedia.com	news
stuttgarter-zeitung.de	news
res.org.uk	scientific
latimes.com	news
scholarshipamerica.org	usgov
zookeys.pensoft.net	scientific
botanica.org.br	scientific
ehawaii.gov	usgov
herp-or.uv.ro	scientific
surgicalneurologyint.com	scientific
stormcloudsgathering.com	fakenews
jsad.com	scientific
wikipedia.com	blog
squidoo.com	blog
scholarspace.manoa.hawaii.edu	scientific
actamedicaportuguesa.com	scientific
bmcurol.biomedcentral.com	scientific
dgs.pa.gov	usgov
geologica.org.ar	scientific
newswithviews.com	fakenews
associatedmediacoverage.com	fakenews
calbotsoc.org	scientific
politique-africaine.com	scientific
nautil.us	news
bjbms.org	scientific
zygonjournal.org	scientific
occ.gov	usgov
newsminer.com	news
pndr.co	socialmedia
escapistmagazine.com	news
amren.com	fakenews
presidio.gov	usgov
annalsofian.org	scientific
jbiomedsem.com	scientific
delhinewsrecord.com	news
bekhterev.ru	scientific
liberazione.it	news
advocate.com	fakenews
cmaj.ca	scientific
upd.sagepub.com	scientific
bmcgenomics.biomedcentral.com	scientific
rb.no	news
islamicanews.com	fakenews
freddiemac.com	usgov
storify.com	socialmedia
biochemj.org	scientific
sexscience.org	scientific
governor.vermont.gov	usgov
rre.sagepub.com	scientific
lavozdegalicia.es	news
bebo.com	socialmedia
envusmotors.com	commercial
govtslaves.info	clickbait|fakenews
asiapharmaceutics.info	scientific
historiasocial.es	scientific
transci.pubs.informs.org	scientific
afrh.gov	usgov
macn.secyt.gov.ar	scientific
news.mingpao.com	news
ijer.ir	scientific
web1.iseas.edu.sg	scientific
larazon.com.ar	news
functionalecology.org	scientific
umich.edu	scientific
derstandard.at	news
oem.bmjjournals.com	scientific
pubsonline.informs.org	scientific
quest-journal.net	scientific
sieds.it	scientific
jn.physiology.org	scientific
sos.state.co.us	usgov
clta-us.org	scientific
torontosun.canoe.ca	news
arenadipola.it	news
weibo.com	socialmedia
ilcittadinomb.it	news
jkas.kas.org	scientific
cor.pa.gov	usgov
jce.sagepub.com	scientific
emol.com	news
gmc.sagepub.com	scientific
pdj.sagepub.com	scientific
tva.gov	usgov
nrronline.org	scientific
governor.delaware.gov	usgov
elmundotoday.com	fakenews
feedblitz.com	news
dol.wa.gov	usgov
nwas.org	scientific
rhe-jilaeh.com	scientific
studentaid.ed.gov	usgov
palgrave-journals.com	scientific
irishnaturalistsjournal.org	scientific
cepc.gob.es	scientific
remotesensing.spiedigitallibrary.org	scientific
arts.gov	usgov
nippur.irb.hr	scientific
therealstrategy.com	fakenews
allenwestrepublic.com	fakenews
governor.arkansas.gov	usgov
tswj.com	scientific
rande.org	scientific
caans-acaen.ca	scientific
gettysburgreview.com	scientific
leaderpost.com	news
roanokereview.wordpress.com	scientific
transcom.mil	usgov
dvr.sagepub.com	scientific
ijp-online.com	scientific
colorado.gov	usgov
rodopi.nl	scientific
mcser.org	scientific
solarphysics.livingreviews.org	scientific
infiniteunknown.net	fakenews
pravdareport.com	fakenews
extension.org	usgov
kosmos.icm.edu.pl	scientific
reductress.com	fakenews
24hrs.ca	news
greensbororeview.org	scientific
journalsleep.org	scientific
nymag.com	news
business-standard.com	news
comsoc.org	scientific
gov.louisiana.gov	usgov
web.archive.org	news|socialmedia|scientific
cvd-journal.de	scientific
jsa.revues.org	scientific
dps.mn.gov	usgov
occupydemocrats.com	fakenews
smf4.emath.fr	scientific
ladiscussione.com	news
ozclub.org	scientific
qroom.ru	socialmedia
dpaa.mil	usgov
lejpb.com	news
grantland.com	news
blog.co.uk	blog
utah.gov	usgov
jse.sagepub.com	scientific
umanitoba.ca	news
ihs.gov	usgov
eia.doe.gov	usgov
pcworld.com	news
conwaydailysun.com	news
cnc.sagepub.com	scientific
samhsa.gov	usgov
usi.edu	scientific
aphapublications.org	scientific
vimeo.com	socialmedia|videos
walker.wi.gov	usgov
spq.sagepub.com	scientific
dps.sagepub.com	scientific
the.sagepub.com	scientific
techvibes.com	news
thejakartapost.com	news
directsoir.net	news
molecularneurodegeneration.com	scientific
spie.org	scientific
inderscience.com	scientific
septentrio.uit.no	scientific
nih.gov	usgov|scientific
injuryjournal.com	scientific
rawstory.com	fakenews
dvd.sagepub.com	scientific
raptorresearchfoundation.org	scientific
ttv.com.tw	scientific
umass.edu	scientific
enet.gr	news
im.microbios.org	scientific
pof.aip.org	scientific
jcm.asm.org	scientific
ceylontoday.lk	news
jdr.sagepub.com	scientific
corrections.utah.gov	usgov
csci.agh.edu.pl	scientific
thepeterboroughexaminer.com	news
ieeemagnetics.org	scientific
dgfo-articulata.de	scientific
ace-eco.org	scientific
monacomatin.mc	news
friendster.com	blog|socialmedia
jneurodevdisorders.com	scientific
dmv.nebraska.gov	usgov
philosophy.emory.edu	scientific
historicalmaterialism.org	scientific
acl.gov	usgov
standard.co.uk	news
jgaa.info	scientific
nctm.org	scientific
corriere.com	news
derfmagazine.com	fakenews
newswatch33.com	fakenews
pfpa.mil	usgov
msnbc.co	fakenews
prisonplanet.tv	clickbait|fakenews
annistonstar.com	news
naugatuckriverreview.com	scientific
dos.myflorida.com	usgov
lequotidien.re	news
biolreprod.org	scientific
blackwell-synergy.com	scientific
itunes.apple.com	blog
doas.ga.gov	usgov
rchn.biologiachile.cl	scientific
mvd.newmexico.gov	usgov
governor.ny.gov	usgov
insightturkey.com	scientific
lematindz.net	news
asma.org	scientific
darujps.com	scientific
jbs.sagepub.com	scientific
newformations.co.uk	scientific
ejtp.com	scientific
jae.oxfordjournals.org	scientific
indianjurol.com	scientific
iseas.edu.sg	scientific
ista.univ-fcomte.fr	scientific
sites.ieee.org	scientific
ncd.gov	usgov
blog.hr	blog
laregione.ch	news
blosxom.sf.net	blog
sumari.hr	scientific
indianexpress.com	news
compliance.gov	usgov
corrieredilivorno.com	news
larepublica.co	news
moikrug.ru	socialmedia
conservativeinfidel.com	fakenews
envplan.com	scientific
medievales.revues.org	scientific
osd.mil	usgov
fasebj.org	scientific
plosntds.org	scientific
redc.revistas.csic.es	scientific
ijps.org	scientific
shoebat.com	fakenews
southcom.mil	usgov
harvard.edu	news
eab.sagepub.com	scientific
historyofscience.jp	scientific
jcx.sagepub.com	scientific
endo.endojournals.org	scientific
omjournal.org	scientific
ocean-science.net	scientific
vestoj.com	scientific
youtube.com	socialmedia|videos
nv.gov	usgov
schattauer.de	scientific
theinquirer.net	news
wvtourism.com	usgov
mms.sagepub.com	scientific
ttb.gov	usgov
thieme.de	scientific
comprehensivephysiology.com	scientific
chyrp.net	blog
drivetribe.com	socialmedia
techdelux.com	blog
tampabay.com	news
ijaaworld.com	scientific
ijtrichology.com	scientific
thesociologicalreview.com	scientific
clinical-lung-cancer.com	scientific
sos.ca.gov	usgov
nvs.sagepub.com	scientific
circumpolarhealthjournal.net	scientific
mcq.sagepub.com	scientific
alabamainteractive.org	usgov
researchgate.net	socialmedia|scientific
ler.letras.up.pt	scientific
airconsumer.ost.dot.gov	usgov
onlinejets.org	scientific
visir.is	news
jaa.uconn.edu	scientific
specgram.com	scientific
ehp.sagepub.com	scientific
persee.fr	scientific
ncdot.gov	usgov
winusvilottery.com	usgov
lanacion.com	news
louisianatravel.com	usgov
energy.gov	usgov
house.gov	usgov
t.co	commercial
icmjournal.esicm.org	scientific
usps.com	usgov
epochtimes.com	news
ijdp.org	scientific
abendblatt.de	news
jop.ascopubs.org	scientific
rbg.vic.gov.au	scientific
counterjihadreport.com	blog
italian-journal-of-mammalogy.it	scientific
aota.org	scientific
jls.sagepub.com	scientific
osdgc.osd.mil	usgov
duhprogressive.com	fakenews
ow.ly	commercial
coffeemeetsbagel.com	socialmedia
csx.sagepub.com	scientific
womansartjournal.org	scientific
hollywood.com	news
cma.ca	scientific
badisches-tagblatt.de	news
worldaffairsjournal.org	scientific
fas.sagepub.com	scientific
strates.revues.org	scientific
travelwisconsin.com	usgov
chemistry.or.jp	scientific
molecbio.com	scientific
rsta.royalsocietypublishing.org	scientific
revistacritica.es	scientific
springer.com	scientific
actachemscand.dk	scientific
vine.co	socialmedia
people.com	news
dailyrecord.co.uk	news
pubs.acs.org	scientific
jalc.de	scientific
mitpress.mit.edu	scientific
yelp.com	socialmedia
computingreviews.com	scientific
www2.johnson.cornell.edu	scientific
businessinsider.com	news
maine.gov	usgov
alzres.com	scientific
magic.pennpress.org	scientific
sss.sagepub.com	scientific
estudiosgallegos.revistas.csic.es	scientific
en.wikipedia.org	blog
catalogingandclassificationquarterly.com	scientific
sikhsiyasat.com	news
afreserve.com	usgov
zaytung.com	fakenews
afsnet.org	scientific
computerweekly.com	news
tc.columbia.edu	scientific
transacl.org	scientific
jbp.sagepub.com	scientific
pagina12.com.ar	news
doa.az.gov	usgov
skepticalraptor.com	blog
cfa.gov	usgov
hcjournal.org	scientific
blesk.cz	news
jhh.sagepub.com	scientific
sef.nu	scientific
racgp.org.au	scientific
shenandoahliterary.org	scientific
ametsoc.org	scientific
pearlmag.com	scientific
jia.sagepub.com	scientific
link.springer.com	scientific
ooyuz.com	commercial
christwire.org	fakenews
elsevier.de	scientific
visitmt.com	usgov
firstpost.com	news
usmagazine.com	news
lesoleil.sn	news
worldoil.com	scientific
uga.edu	scientific
computermusicjournal.org	scientific
economics.sas.upenn.edu	scientific
store.elsevier.com	scientific
abmc.gov	usgov
ojoonline.org	scientific
anobii.com	socialmedia
etyka.uw.edu.pl	scientific
alcesjournal.org	scientific
medscape.com	news
hurriyet.com.tr	news
isc.sagepub.com	scientific
fncv.org.au	scientific
ccj.sagepub.com	scientific
orchardproject.net	blog
aynrandstudies.com	scientific
hetcomm.tripod.com	scientific
jrp.icaap.org	scientific
liberation-champagne.fr	news
education.com	commercial
salon.com	news
awarenessact.com	fakenews
embols.com	fakenews
asianage.com	news
arbeiterbewegung-jahrbuch.de	scientific
lse.ma	news
hochi.co.jp	news
dol.gov	usgov
ajp.org	scientific
foursquare.com	socialmedia
haaretz.co.il	news
commons.pacificu.edu	scientific
jbx.sagepub.com	scientific
thevalleyreport.com	fakenews
guamtax.com	usgov
top.sagepub.com	scientific
revintsociologia.revistas.csic.es	scientific
acm.org	scientific
ijm.sagepub.com	scientific
kentucky.gov	usgov
postcourier.com.pg	news
poi.sagepub.com	scientific
seattlepi.com	news
seminascientiarum.wikidot.com	scientific
fta.dot.gov	usgov
ksml.fi	news
ebay.com	commercial
usqr.utsnyc.edu	scientific
danskteologisktidsskrift.dk	scientific
jap.physiology.org	scientific
reflexe.cz	scientific
estudiosnietzsche.org	scientific
philippinestudies.net	scientific
toprightnews.com	fakenews
nisc.co.za	scientific
usnews.com	news
pch.sagepub.com	scientific
freewoodpost.com	fakenews
ilquotidianofvg.it	news
mingpaotor.com	news
cjb.sagepub.com	scientific
phytomedicinejournal.com	scientific
bjp.rcpsych.org	scientific
bayesian.org	scientific
quodlibet.net	scientific
hna.de	news
russianreview.org	scientific
jhl.sagepub.com	scientific
counterpsyops.com	clickbait|fakenews
zgw-online.de	scientific
irm.sagepub.com	scientific
signalprocessingsociety.org	scientific
cjc.wiley-vch.de	scientific
rdtp.revistas.csic.es	scientific
chelonian.org	scientific
facebook.com	socialmedia
omv.dps.state.la.us	usgov
ama.org	scientific
ageofautism.com	fakenews
adf.gov	usgov
jaapa.com	scientific
mlive.com	news
aoa.gov	usgov
jimmunol.org	scientific
thorax.bmj.com	scientific
portal.uspto.gov	usgov
ibis.ac.uk	scientific
urbani-izziv.uirs.si	scientific
deadstate.org	blog
resuscitationjournal.com	scientific
corsematin.com	news
dailymirror.lk	news
az.gov	usgov
dubois.fas.harvard.edu	scientific
journal.georgetown.edu	scientific
firescience.gov	usgov
governor.mt.gov	usgov
baslerstab.ch	news
methodsinecologyandevolution.org	scientific
www3.wooster.edu	scientific
ok.gov	usgov
genome.cshlp.org	scientific
i-journals.org	scientific
shellmuseum.org	scientific
rrb.gov	usgov
eth.sagepub.com	scientific
news.anotao.com	blog
ilmattino.it	news
express.co.uk	news
xing.com	socialmedia
jamia.org	scientific
asahi.com	news
archim.org.uk	scientific
ojjdp.gov	usgov
jos.nu	scientific
espritcreateur.umn.edu	scientific
acorn.sbu.edu	scientific
proudcons.com	fakenews
doc-catho.com	scientific
laprovinciadivarese.it	news
focm-society.org	scientific
fortaleza.pr.gov	usgov
rubber.org	scientific
jie.sagepub.com	scientific
parasite-journal.org	scientific
nationalguard.mil	usgov
psychiatrictimes.com	scientific
linformazione.com	news
governor.alabama.gov	usgov
ezinearticles.com	blog
filosofianeoscolastica.vitaepensiero.it	scientific
berlindailysun.com	news
rethinkingmarxism.org	scientific
ucowr.org	scientific
revistavegueta.ulpgc.es	scientific
stripes.com	news
ny.gov	usgov
sjweh.fi	scientific
goupstate.com	news
scmsgroup.org	scientific
vqronline.org	scientific
lapresse.ca	news
hsj.co.uk	scientific
theuspatriot.com	fakenews
moneyfactory.gov	usgov
mediamatinquebec.com	news
indiatimes.com	news
tbf.coe.wayne.edu	scientific
medscimonit.com	scientific
govnews.ca.gov	usgov
poj.peeters-leuven.be	scientific
defenddemocracy.press	fakenews
variety.com	news
bohuslaningen.se	news
journals.ku.edu	scientific
anonews.co	fakenews
truepundit.com	fakenews
linkedin.com	socialmedia
revistas.pucp.edu.pe	scientific
thedailymash.co.uk	fakenews
chroniclejournal.com	news
jcytol.org	scientific
bb4sp.com	fakenews
mlq.dukejournals.org	scientific
ann.sef.free.fr	scientific
go.com	news
twister.net.co	blog
baltimoreexaminer.com	news
jsw.sagepub.com	scientific
atropos.info	scientific
healthpolicyjrnl.com	scientific
squarespace.com	blog
smq.sagepub.com	scientific
kodiakdailymirror.com	news
jeb.biologists.org	scientific
cell-research.com	scientific
technologyreview.com	news
rnajournal.cshlp.org	scientific
cww.oxfordjournals.org	scientific
epubs.icar.org.in	scientific
biodiversitylibrary.org	scientific
swtimes.com	news
csosa.gov	usgov
sex.sagepub.com	scientific
truthandaction.org	fakenews
carcinogenesis.com	scientific
amcs.uz.zgora.pl	scientific
emeraldgrouppublishing.com	scientific
revuedecapage.blogspot.fr	scientific
thelastgreatstand.com	fakenews
intjit.org	scientific
minervamedica.it	scientific
epilepsia.com	scientific
ntsb.gov	usgov
ilpiccolo.it	news
iwim.uni-bremen.de	scientific
anotherdayintheempire.com	fakenews
qoura.com	blog
erica.demon.co.uk	scientific
ajh.oxfordjournals.org	scientific
gazeta-pravda.ru	news
journalofanimalecology.org	scientific
small-journal.com	scientific
dmv.virginia.gov	usgov
architalbiol.org	scientific
nro.sagepub.com	scientific
orientalbirdclub.org	scientific
ebn.bmj.com	scientific
nys.dk	scientific
villanova.edu	scientific
karjalainen.fi	news
journalofbehavioralfinance.org	scientific
revuefrancaisedeconomie.fr	scientific
hgp.sagepub.com	scientific
laprovence.com	news
revistas-filologicas.unam.mx	scientific
elcomercio.pe	news
drudgereport.com	fakenews
voppsy.ru	scientific
ilromanista.it	news
ecologia.edu.mx	scientific
governor.guam.gov	usgov
aas.sagepub.com	scientific
chembiochem.org	scientific
dailycaller.com	news|fakenews
miamiherald.com	news
digitaltrends.com	news
disclose.tv	clickbait|fakenews
data.bnf.fr	scientific
bloodtransfusion.it	scientific
amjbot.org	scientific
datz.de	scientific
jjmie.hu.edu.jo	scientific
ech-chaab.com	news
schizophreniabulletin.oxfordjournals.org	scientific
jpo.sagepub.com	scientific
sonicdesign.org	scientific
sba.gov	usgov
jap.sagepub.com	scientific
journals.sub.uni-hamburg.de	scientific
interfacejournal.net	scientific
letempsdz.com	news
hsm.sagepub.com	scientific
portal.hud.gov	usgov
journals.sabinet.co.za	scientific
decadrages.ch	scientific
quotidianodelsud.it	news
sram.org	scientific
kitsapsun.com	news
sim.sagepub.com	scientific
bmcpediatr.biomedcentral.com	scientific
mollus.oxfordjournals.org	scientific
maneyonline.com	scientific
eff.org	news
plantsystematics.com	scientific
akademiai.com	scientific
historia-actual.org	scientific
ess.fi	news
waz.de	news
rgdip.com	scientific
reddeeradvocate.com	news
ndu.edu	usgov
jhmas.oxfordjournals.org	scientific
amta.no	news
aott.org.tr	scientific
aidai.us	scientific
economicsbulletin.com	scientific
thespinejournalonline.com	scientific
dailycomet.com	news
elections.alaska.gov	usgov
ssa.gov	usgov
realtimepolitics.com	fakenews
dps.gov.mp	usgov
eveningtimes.co.uk	news
ibtimes.com	news
bjo.bmj.com	scientific
maneypublishing.com	scientific
paho.org	scientific
mesharpe.com	scientific
newsbreakers.org	fakenews
massreview.org	scientific
fas.usda.gov	usgov
wakingupwisconsin.com	clickbait|fakenews
andrewjohnpublishing.com	scientific
iehca.eu	scientific
nationalpost.com	news
ntnu.no	scientific
nationalgeographic.com	news
ok.ru	socialmedia
ilmessaggero.it	news
kritike.org	scientific
gct.sagepub.com	scientific
oxrep.oxfordjournals.org	scientific
virginia.org	usgov
dtic.mil	usgov
jfr.unibo.it	scientific
das.ohio.gov	usgov
pravda.sk	news
naika.or.jp	scientific
euppublishing.com	scientific
nwtrb.gov	usgov
jia.sipa.columbia.edu	scientific
tr.instela.com	socialmedia
gaia-online.net	scientific
ssi.sagepub.com	scientific
giornaledeglieconomisti.unibocconi.it	scientific
vertpaleo.org	scientific
fjc.gov	usgov
zoologischemededelingen.nl	scientific
zimbio.com	blog
ww2.wapa.gov	usgov
geotar.ru	scientific
rswa.org.au	scientific
akismet.com	blog
ids.thomsonreuters.com	scientific
acta.chem-soc.si	scientific
vi.gov	usgov
chd.sagepub.com	scientific
radiographyonline.com	scientific
jel.sagepub.com	scientific
cpsc.gov	usgov|news
msforum.net	scientific
jech.bmj.com	scientific
khabaristantimes.com	fakenews
orthopaedic-nursing.com	scientific
ready.gov	usgov
ijstd.org	scientific
lifetype.net	blog
livemint.com	news
jhs.sagepub.com	scientific
talkingpointsmemo.com	news
inc.com	news
elsevierhealth.com	scientific
storysouth.com	scientific
lkcnhm.nus.edu.sg	scientific
dni.gov	usgov
sepa.doe.gov	usgov
soe.sagepub.com	scientific
ijims.ms.tku.edu.tw	scientific
biolcell.net	scientific
realnewsrightnow.com	fakenews
estudiosmedievales.revistas.csic.es	scientific
eclkc.ohs.acf.hhs.gov	usgov
derecho.uba.ar	scientific
michiganlottery.com	usgov
jacksonville.com	news
talcualdigital.com	news
gov.nv.gov	usgov
icb.oxfordjournals.org	scientific
physsportsmed.org	scientific
advopticalmat.de	scientific
jou.sagepub.com	scientific
aujourdhui.ma	news
lexikos.journals.ac.za	scientific
kinja.com	blog
palaios.sepmonline.org	scientific
spd.dcu.ie	scientific
kerux.com	scientific
tvn.sagepub.com	scientific
journalofplay.org	scientific
google.com	blog
beingliberal.org	fakenews
lecourrier.vn	news
fe.doe.gov	usgov
dau.mil	usgov
vet.sagepub.com	scientific
davidduke.com	fakenews
annalsoftransplantation.com	scientific
gtd.sagepub.com	scientific
lamontagne.fr	news
jiasociety.org	scientific
aoc.gov	usgov
usmc.mil	usgov
allnewspipeline.com	fakenews
jornaldeangola.sapo.ao	news
ipernity.com	socialmedia
qjae.org	scientific
rhr.revues.org	scientific
iheu.org	scientific
stennis.gov	usgov
lakartidningen.se	scientific
epa.sagepub.com	scientific
nrc.gov	usgov
magazineforhealthy.com	blog
aacp.com	scientific
governor.nd.gov	usgov
gab.wi.gov	usgov
jnt.sagepub.com	scientific
neworleansreview.org	scientific
milenio.com	news
longriverreview.com	scientific
latercera.com	news
ladepeche.pf	news
visitmo.com	usgov
amny.com	news
jb.oxfordjournals.org	scientific
filmquarterly.org	scientific
migrationletters.com	scientific
ncsu.edu	scientific
jtc.sagepub.com	scientific
witness.blackmountaininstitute.org	scientific
governor.ks.gov	usgov
indianareview.org	scientific
rhpr.net	scientific
nutritionreviews.oxfordjournals.org	scientific
rspa.royalsocietypublishing.org	scientific
bjj.boneandjoint.org.uk	scientific
pvs.sagepub.com	scientific
ole.clarin.com	news
lacote.ch	news
bielertagblatt.ch	news
samla.gsu.edu	scientific
smf.emath.fr	scientific
lib.unb.ca	scientific
jpost.com	news
autojusticeattorney.com	commercial
bclocalnews.com	news
english.ufl.edu	scientific
wt.diecezja.tarnow.pl	scientific
kypost.com	news
nbn-resolving.de	news|scientific
rp.pl	news
kathmandupost.ekantipur.com	news
esajournals.org	scientific
aed.sagepub.com	scientific
dna.fr	news
betootaadvocate.com	fakenews
expressen.se	news
pmj.bmj.com	scientific
houmatoday.com	news
tochi.acm.org	scientific
carnivorousplants.org	scientific
geolsoc.org.uk	scientific
parnaseo.uv.es	scientific
hs.fi	news
rcnpublishing.com	scientific
placentajournal.org	scientific
nrc.nl	news
nmb.gov	usgov
cfo.gov	usgov
maturitas.org	scientific
ngnews.ca	news
maalaimalar.com	news
lyonne-republicaine.fr	news
lentomologiste.fr	scientific
ndrmag.org	scientific
yumasun.com	news
dcboee.org	usgov
org.sagepub.com	scientific
blackwell-compass.com	scientific
therightists.com	fakenews
thepatient.adisonline.com	scientific
musiclibraryassoc.org	scientific
duncker-humblot.de	scientific
bfictionreview.wordpress.com	scientific
gamepolitics.com	blog|news
chartattack.com	news
aqua-aquapress.com	scientific
ci.nii.ac.jp	scientific
scoliosisjournal.biomedcentral.com	scientific
idoc.state.il.us	usgov
uscirf.gov	usgov
journal-surgery.net	scientific
constitutioncenter.org	usgov
incomesdata.co.uk	scientific
iris.custhelp.com	usgov
eid.sagepub.com	scientific
publicsurplus.com	usgov
europeanurology.com	scientific
gamesindustry.biz	news
tug.org	scientific
clt.sagepub.com	scientific
unioviedo.es	scientific
windsorstar.com	news
b2evolution.net	blog
wenweipo.com	news
israelhayom.com	news
press.uillinois.edu	scientific
psychologicabelgica.com	scientific
diabetologia-journal.org	scientific
tidsskriftet.no	scientific
hln.be	news
ncua.gov	usgov
vancouversun.com	news
aanda.org	scientific
techreport.com	news
thechronicleherald.ca	news
perspectiveschinoises.revues.org	scientific
aim.bmj.com	scientific
jrn.sagepub.com	scientific
ijr.sagepub.com	scientific
who.eop.gov	usgov
governor.pa.gov	usgov
carcin.oxfordjournals.org	scientific
theijhss.com	scientific
thestatelyharold.com	fakenews
lethbridgeherald.com	news
jackpineradicals.com	fakenews
wjgnet.com	scientific
journal.r-project.org	scientific
elmundo.es	news
other98.com	fakenews
bjgp.org	scientific
forbes.com	news
accesshollywood.com	news
lobservateur.cd	news
thewire.in	news
minsocam.org	scientific
act.gov	usgov
cigie.gov	usgov
sad.sagepub.com	scientific
soundcloud.com	socialmedia
palmbeachpost.com	news
goo.gl	commercial
nepszava.hu	news
jopr.mpob.gov.my	scientific
danas.rs	news
legislative.noaa.gov	usgov
subtextproject.com	blog
huh.harvard.edu	scientific
nowpublishers.com	scientific
cns.gov	usgov
ctoz.nl	scientific
jabfm.org	scientific
mythsoc.org	scientific
novitasroyal.org	scientific
jrheum.org	scientific
notallowedto.com	fakenews
nro.gov	usgov
cia.gov	usgov|scientific
jewsnews.co.il	fakenews
redstate.com	news
www2.filg.uj.edu.pl	scientific
degruyter.de	scientific
melanienini.net	commercial
amergeog.org	scientific
dpscs.state.md.us	usgov
ccl.sagepub.com	scientific
jspsciences.org	scientific
jpml.uscourts.gov	usgov
mainichi.co.jp	news
treas.gov	usgov
mercola.com	fakenews
doc.state.mn.us	usgov
lapinkansa.fi	news
koedoe.co.za	scientific
conservation-science.unibo.it	scientific
valottery.com	usgov
wyo.gov	usgov
afonet.org	scientific
nh.gov	usgov
denali.gov	usgov
gigaom.com	news
conchsoc.org	scientific
blogspot.com	blog
people.carleton.edu	scientific
contexts.org	scientific
feministeconomics.org	scientific
aag.org	scientific
muehlacker-tagblatt.de	news
amjmed.com	scientific
huduser.org	usgov
sanluisobispo.com	news
www2.washjeff.edu	scientific
psp.sagepub.com	scientific
aspentimes.com	news
welt.de	news
mtv.com	news
jonesreport.com	clickbait|fakenews
sorites.org	scientific
scienceblogs.com	blog
pump.io	blog
jmk.sagepub.com	scientific
ottawacitizen.com	news
epl.delfi.ee	news
hakirah.org	scientific
psyanima.su	scientific
hahr.dukejournals.org	scientific
governor.nebraska.gov	usgov
crx.sagepub.com	scientific
helpwithmybank.gov	usgov
api.org.za	scientific
libre.inquirer.net	news
rmi-op.net	usgov
hindawi.com	scientific
nah.sagepub.com	scientific
arss.fr	scientific
psychosomaticmedicine.org	scientific
opticsinfobase.org	scientific
oepf.org	scientific
helsinki.fi	scientific
hcommons.org	socialmedia
rfs-revue.com	scientific
bise-journal.org	scientific
jcb.org	scientific
saber.ula.ve	scientific
ahistcon.org	scientific
frontiersinzoology.com	scientific
tageblatt.de	news
isp.sagepub.com	scientific
ambito.com	news
dfa.arkansas.gov	usgov
amc.imfm.si	scientific
governor.nc.gov	usgov
gupress.gallaudet.edu	scientific
ijs.sagepub.com	scientific
brill.com	scientific
adeca.alabama.gov	usgov
kentuckytourism.com	usgov
jmh.sagepub.com	scientific
sharylattkisson.com	blog
ias.ac.in	scientific
mbs-journal.de	scientific
geology.gsapubs.org	scientific
flensborg-avis.de	news
pep.wiley-vch.de	scientific
entsocwash.org	scientific
mcponline.org	scientific
essor.ml	news
rilenews.com	fakenews
thieme-chemistry.com	scientific
sht.ut.ee	scientific
ehp03.niehs.nih.gov	scientific
eonline.com	news
ccsu.edu	scientific
duffleblog.com	satire|fakenews
cri.sagepub.com	scientific
aaap.info	scientific
mbda.gov	usgov
khan.co.kr	news
disputatio.com	scientific
sigmaaldrich.com	scientific
bt.no	news
gladius.revistas.csic.es	scientific
rollcall.com	news
humantechnology.jyu.fi	scientific
aoucospubs.org	scientific
prlog.org	blog
moonofalabama.org	fakenews
wyomingtourism.org	usgov
cd.nm.gov	usgov
leibnizreview.com	scientific
ussc.gov	usgov
annals.org	scientific
ijs.speleo.it	scientific
jbd.sagepub.com	scientific
toucharcade.com	news
thisispinball.com	scientific
prouddemocrat.com	fakenews
oro.doe.gov	usgov
bul.sagepub.com	scientific
ironictimes.com	fakenews
water.usgs.gov	usgov
conservativedailypost.com	fakenews
governor.nh.gov	usgov
visit-vermont.com	usgov
doc.dc.gov	usgov
thenation.com	news
thetelegram.com	news
cacm.acm.org	scientific
lpl.arizona.edu	scientific
ijr.com	fakenews
risk.net	scientific
ct.gov	usgov
ijsi.org	scientific
prisonplanet.com	clickbait|fakenews
montanalottery.com	usgov
fivethirtyeight.com	news
senscritique.com	socialmedia
moihelsinki.com	socialmedia
yaklass.ru	socialmedia
mwc.sagepub.com	scientific
pen.org	scientific
maariv.co.il	news
jph.asu.edu	scientific
visitpa.com	usgov
nrcs.usda.gov	usgov
debunkingskeptics.com	fakenews
thehill.com	news
wires.wiley.com	scientific
novus.no	scientific
histoiremesure.revues.org	scientific
fahrenheitmagazine.com	scientific
aff.sagepub.com	scientific
blogger.com	blog|socialmedia
scienceandsociety.com	scientific
est.sagepub.com	scientific
myflorida.com	usgov
scholarworks.iu.edu	scientific
secretsofthefed.com	fakenews
dwxzz.ioz.ac.cn	scientific
slavicreview.illinois.edu	scientific
jambo.africa.kyoto-u.ac.jp	scientific
jrse.aip.org	scientific
jod.sagepub.com	scientific
jdnews.com	news
alger-republicain.com	news
daily.co.jp	news
truthpoliticsnews.com	fakenews
theonion.com	satire|fakenews
arkat-usa.org	scientific
annsaudimed.net	scientific
prntly.com	fakenews
andrews.edu	scientific
cdt.ch	news
xjdaily.com	news
vitweet.com	blog
bjs.ojp.usdoj.gov	usgov
bu.edu	scientific
plantcell.org	scientific
israelislamandendtimes.com	fakenews
ca.gov	usgov
ajkd.org	scientific
governor.sc.gov	usgov
pclob.gov	usgov
arthroscopyjournal.org	scientific
jams-kpi.com	scientific
bls.gov	usgov|scientific
biostatistics.oxfordjournals.org	scientific
sss.gov	usgov
unconfirmedsources.com	clickbait|fakenews
vetsci.org	scientific
huzlers.com	satire|fakenews
flgov.com	usgov
mjtimes.sk.ca	news
fishbull.noaa.gov	scientific
qje.oxfordjournals.org	scientific
tellusa.net	scientific
jvdi.sagepub.com	scientific
kayhan.ir	news
llgc.org.uk	scientific
ndquarterly.org	scientific
awt.cbp.gov	usgov
visitthecapitol.gov	usgov
aobjournal.com	scientific
amtrak.com	usgov
scf.hhs.gov	usgov
utsa.edu	scientific
governor.state.nm.us	usgov
faa.gov	usgov
ink.org	usgov
chronicle.gi	news
upress.umn.edu	scientific
kennedy-center.org	usgov
oss.sagepub.com	scientific
haaretz.com	news
cimarronreview.okstate.edu	scientific
fhaoutreach.com	usgov
saarbruecker-zeitung.de	news
jobcorps.gov	usgov
realfarmacy.com	clickbait|fakenews
cambridge.org	scientific
blogdrive.com	blog
ojs.ub.gu.se	scientific
ascilite.org.au	scientific
nzjf.org	scientific
imath.kiev.ua	scientific
francesoir.fr	news
drupal.org	blog
gwu.edu	scientific
le10sport.com	news
fmcsa.dot.gov	usgov
kahoku.co.jp	news
sz-online.de	news
motherboard.vice.com	news
arages.de	scientific
jpsmjournal.com	scientific
phytoneuron.net	scientific
ftd.de	news
thenewinquiry.com	fakenews
informaworld.com	scientific
ajp.psychiatryonline.org	scientific
dailysquib.co.uk	fakenews
ijdb.ehu.es	scientific
depts.drew.edu	scientific
americanforensics.org	scientific
langtech.dickinson.edu	scientific
sos.wa.gov	usgov
rickwells.us	fakenews
portal.state.pa.us	scientific
cs.ucsb.edu	scientific
hadashot-esi.org.il	scientific
jsw.arizona.edu	scientific
doc.ri.gov	usgov
pharmacypractice.org	scientific
an.no	news
tva.com	usgov
jrc.sagepub.com	scientific
journaldemontreal.com	news
pdnonline.com	scientific
neurosurgery-online.com	scientific
channel-7-news.com	fakenews
newmexico.org	usgov
aje.oxfordjournals.org	scientific
uscourts.gov	usgov
zerotothree.org	scientific
ies.ed.gov	usgov
dmv.de.gov	usgov
mmd.sagepub.com	scientific
jmmab.com	scientific
ajs.or.at	scientific
corrieredicomo.it	news
presidiotrust.gov	usgov
revistaestudiosregionales.com	scientific
canteenmag.com	scientific
praksis.org	scientific
visnik.knteu.kiev.ua	scientific
ccp.sagepub.com	scientific
dss.mil	usgov
sgr.sagepub.com	scientific
etn.sagepub.com	scientific
jospt.org	scientific
physrev.physiology.org	scientific
hepg.org	scientific
exchanges.state.gov	usgov
epigeneticsandchromatin.com	scientific
columbiadailyherald.com	news
cla.sagepub.com	scientific
nmag.gov	usgov
fc.eop.gov	usgov
thewatchtowers.com	fakenews
ijg.sagepub.com	scientific
aoac.org	scientific
cnsfederation.org	scientific
photostreet.com	blog
ine.pt	scientific
ohiostatepress.org	scientific
jurology.com	scientific
dms.myflorida	usgov
visit-massachusetts.com	usgov
feeries.revues.org	scientific
who.int	scientific
alternative-therapies.com	scientific
revistaseug.ugr.es	scientific
uar.sagepub.com	scientific
democratandchronicle.com	news
dot.gov	usgov
bjcp-journal.com	scientific
ang.sagepub.com	scientific
web.novus.no	scientific
cysjournal.ca	scientific
st.nu	news
heraldsun.com.au	news
dailycamera.com	news
aesnet.org	scientific
proteinscience.org	scientific
rmmc.eas.asu.edu	scientific
aidc.org.za	fakenews
dcwhispers.com	fakenews
smu.edu	scientific
africaninvertebrates.org	scientific
na.se	news
themedicalroundtable.com	scientific
inkwelljournal.org	scientific
rcb.sagepub.com	scientific
hindustantimes.com	news
revistas.uam.es	scientific
americanprogress.org	fakenews
biology-direct.com	scientific
www2.va.gov	usgov
asm.sagepub.com	scientific
epa.gov	usgov
usda.gov	usgov|scientific
uscp.gov	usgov
mpidailymagazine.com	fakenews
issr-journals.org	scientific
ajhsjournal.or.ke	scientific
polygon.com	news
ebtekarnews.com	news
howstuffworks.com	news
meajo.org	scientific
sycamorereview.com	scientific
treasurydirect.gov	usgov
isb.sagepub.com	scientific
journals.ju.edu.jo	scientific
readthebestwriting.com	scientific
ncsc.gov	usgov
eldia.es	news
wsj.com	news
nahadaily.com	satire|fakenews
fbi.gov	usgov
ucmo.edu	scientific
tuttosport.com	news
lancenet.com.br	news
journals.berghahnbooks.com	scientific
jstage.jst.go.jp	scientific
aespa.revistas.csic.es	scientific
sos.idaho.gov	usgov
gargoylemagazine.com	scientific
gastrointestinalnursing.co.uk	scientific
zdnet.com	blog
dps.hawaii.gov	usgov
biomedcentral.com	scientific
dirty.ru	blog
tnm.jp	scientific
thejpd.org	scientific
newsweek.com	news
wmr.sagepub.com	scientific
myrmecologicalnews.org	scientific
keskipohjanmaa.net	news
mymarianas.com	usgov
newswatch28.com	fakenews
acta.sapientia.ro	scientific
bpa.gov	usgov
revue.etudes-episteme.org	scientific
peeters-leuven.be	scientific
blog.com	blog
fiscalcommission.gov	usgov
wjoonline.org	scientific
maryland.gov	usgov
theoryofcomputing.org	scientific
nursesinaidscarejournal.org	scientific
ap.org	news|fakenews
secstates.com	usgov
icm.csic.es	scientific
newsexaminer.com	fakenews
tenri-u.ac.jp	scientific
neurophotonics.spiedigitallibrary.org	scientific
blick.ch	news
wiley-vch.de	scientific
ojogo.pt	news
ons.org	scientific
amsocparasit.org	scientific
thz.ieee.org	scientific
eucom.mil	usgov
gamespot.com	news
newmexico.gov	usgov
cardiab.com	scientific
hispaniasacra.revistas.csic.es	scientific
michiganjb.org	scientific
duffelblog.com	fakenews
snreview.org	scientific
pediatrics.aappublications.org	scientific
newsday.com	news
itd.idaho.gov	usgov
societedesetudeslatines.com	scientific
annualreviews.org	scientific
smj.org.sa	scientific
ncp.sagepub.com	scientific
jama.ama-assn.org	scientific
jpubhealth.oxfordjournals.org	scientific
prehistoire.org	scientific
ieeexplore.ieee.org	scientific
tseg.nl	scientific
freebeacon.com	fakenews
eforms.state.gov	usgov
etsy.com	commercial
nats.org	scientific
usa.gov	usgov
ascelibrary.org	scientific
learnerblogs.org	blog
azcentral.com	news
abs.sagepub.com	scientific
tidsskrift.dk	scientific
vid.staged.com	commercial
rseq.org	scientific
tandfonline.com	scientific
jpf.sagepub.com	scientific
nysun.com	news
tobunken.go.jp	scientific
newstarget.com	fakenews
vk.com	socialmedia
ieee-ceda.org	scientific
apparatusjournal.net	scientific
koreascience.or.kr	scientific
bernerzeitung.ch	news
partialanswers.huji.ac.il	scientific
cyworld.com	socialmedia
msnbc.website	fakenews
patheos.com	blog
lqj.ch	news
jules-verne.net	scientific
repubblica.it	news
theplantlist.org	scientific
intmedpress.com	scientific
ams.allenpress.com	scientific
arsdisputandi.org	scientific
treasury.gov	usgov
sec.gov	usgov
fictioninternational.com	scientific
cvawards.ca	news
geoscientific-model-development.net	scientific
economist.com	news
crln.acrl.org	scientific
paecon.net	scientific
mind.oxfordjournals.org	scientific
wilsoncenter.org	usgov
projectveritas.com	fakenews
revuedesdeuxmondes.fr	scientific
pubs.nrc-cnrc.gc.ca	scientific
tfc.state.tx.us	usgov
bmcmicrobiol.biomedcentral.com	scientific
jmo.sagepub.com	scientific
exoplatform.com	blog
travelalaska.com	usgov
agriscientia.unc.edu.ar	scientific
rs9.loc.gov	usgov
ccs.sagepub.com	scientific
blm.gov	usgov
sific.it	news
kansasacademyscience.org	scientific
op-marburg.de	news
translational-medicine.com	scientific
tpx.sagepub.com	scientific
afrc.af.mil	usgov
usanewsinsider.com	fakenews
aafp.org	scientific
jab.sagepub.com	scientific
discoversouthcarolina.com	usgov
webapp6.rrz.uni-hamburg.de	scientific
jsp.sagepub.com	scientific
yas.sagepub.com	scientific
megynkelly.us	clickbait|fakenews
madebyfrog.com	blog
f1000research.com	scientific
um.es	scientific
caller.com	news
reep.oxfordjournals.org	scientific
gawker.com	news
freiepresse.de	news
tropicalgrasslands.asn.au	scientific
jcda.ca	scientific
informationclearinghouse.info	fakenews
france.attac.org	scientific
jgid.org	scientific
hollywoodreporter.com	news
ador.alabama.gov	usgov
anilaggrawal.com	scientific
samuel-warde.com	fakenews
leconomiste.com	news
heraldscotland.com	news
lewrockwell.com	clickbait|fakenews
clemson.edu	scientific
arc.aiaa.org	scientific
ijs.sgmjournals.org	scientific
offices.sc.egov.usda.gov	usgov
ordo-journal.com	scientific
abbs.oxfordjournals.org	scientific
morningstaronline.co.uk	news
webnodes.com	blog
constellationsjournal.org	scientific
politicalears.com	fakenews
philly.com	news
fedstats.sites.usa.gov	usgov
undergroundworldnews.com	fakenews
theineptowl.com	fakenews
con.sagepub.com	scientific
epjdatascience.springeropen.com	scientific
unav.es	scientific
laliberte.ch	news
endtime.com	fakenews
americanfreepress.net	fakenews
aslonline.org	scientific
online.uni-hd.de	scientific
twitterrific.com	blog
cms.gov	usgov
baltimorereview.org	scientific
mcb.asm.org	scientific
fhwa.dot.gov	usgov
rac.es	scientific
kristianstadsbladet.se	news
rurdev.usda.gov	usgov
ijqhw.net	scientific
criticalinquiry.uchicago.edu	scientific
ijmes.chass.ncsu.edu	scientific
www2.ed.gov	usgov
sanp.ch	scientific
samj.org.za	scientific
alh.sagepub.com	scientific
jsbba.or.jp	scientific
jaad.org	scientific
larecherche.fr	scientific
cigjournals.com	scientific
polarresearch.net	scientific
washingtontimes.com	news
americablog.com	fakenews
mbe.oxfordjournals.org	scientific
tpj.sagepub.com	scientific
masslottery.com	usgov
journalofecology.org	scientific
ugeskriftet.dk	scientific
rcplondon.ac.uk	scientific
cem.va.gov	usgov
fg.uni-mb.si	scientific
usatoday.com	news
pensoft.net	scientific
wvdoc.com	usgov
iowa.gov	usgov
thevaccinereaction.org	blog
press.jhu.edu	scientific
eurosurveillance.org	scientific
jfh.sagepub.com	scientific
amstat.org	scientific
studiasocjologiczne.pl	scientific
doi.gov	usgov
berliner-kurier.de	news
countdowntozerotime.com	clickbait|fakenews
howdovaccinescauseautism.com	blog
politicususa.com	fakenews
pennstatebehrend.psu.edu	scientific
lohud.com	news
ilgiorno.it	news
wideawakeamerica.com	clickbait|fakenews
law.tau.ac.il	scientific
bbc.co.uk	news
tresor.economie.gouv.fr	scientific
bia.gov	usgov
wix.com	blog
jfmpc.gcal.ac.uk	scientific
techinsider.io	news
jiv.sagepub.com	scientific
onlinelibrary.wiley.com	scientific
jhi.sagepub.com	scientific
nga.gov	usgov
ut.ee	scientific
chs.revues.org	scientific
screen.arts.gla.ac.uk	scientific
aef.izibookstore.com	scientific
interrev.com	scientific
postgradmed.org	scientific
analescervantinos.revistas.csic.es	scientific
dailynewsbin.com	fakenews
amstat.tandfonline.com	scientific
tih.sagepub.com	scientific
narrowgaugeandindustrial.co.uk	scientific
cts.access-board.gov	usgov
alzheimerjournal.com	scientific
njlottery.com	usgov
liberalamerica.org	fakenews
utoronto.ca	scientific
blasting.news	fakenews
ar.iiarjournals.org	scientific
now8news.	fakenews
9gag.com	socialmedia
gji.oxfordjournals.org	scientific
prealpina.it	news
ach.sagepub.com	scientific
fftsecurity.com	scientific
adr.gov	usgov
informationgrammaticale.com	scientific
telegraaf.nl	news
tde.sagepub.com	scientific
politicalo.com	fakenews
romagnanoi.it	news
creambmp.com	fakenews
empirenews.net	fakenews
visitnebraska.com	usgov
nas.sagepub.com	scientific
nms.sagepub.com	scientific
trn.sagepub.com	scientific
plosmedicine.org	scientific
gomerblog.com	satire|fakenews
silvagabreta.npsumava.cz	scientific
ijfab.org	scientific
vcps.org	scientific
le-petitbleu.fr	news
newsherald.com	news
jpet.aspetjournals.org	scientific
californiatourism.ca.gov	usgov
jeb.co.in	scientific
pjahs.ust.edu.ph	scientific
ncdps.gov	usgov
jacr.org	scientific
journals.plos.org	scientific
lyceum.ibiblio.org	blog
zsm.mwn.de	scientific
lemonde.fr	news
orwac.org	scientific
hq.nasa.gov	usgov
hhs.gov	usgov
inscribe.iupress.org	scientific
jclinepi.com	scientific
jpgmonline.com	scientific
sas.sagepub.com	scientific
cancerepidemiology.net	scientific
darkmoon.me	fakenews
messaggeroveneto.it	news
navy.com	usgov
ualberta.ca	scientific
nws.noaa.gov	usgov
appleinsider.com	blog
state.ca.gov	usgov
telegraphjournal.com	news
marines.com	usgov
jsi.sagepub.com	scientific
tocs.acm.org	scientific
visitmississippi.org	usgov
conspiracyplanet.com	fakenews
nbc.com.co	fakenews
acadienouvelle.com	news
almasryalyoum.com	news
foreignpolicy.com	news
ext.sagepub.com	scientific
gazzettadireggio.gelocal.it	news
fsmgov.org	usgov
superdeporte.es	news
dds.ga.gov	usgov
sonic.net	scientific
bambooridge.com	scientific
sueddeutsche.de	news
critica.filosoficas.unam.mx	scientific
ijmpo.org	scientific
ejves.com	scientific
lifezette.com	fakenews
theoxymoron.co.uk	fakenews
iopscience.iop.org	scientific
al.com	news
liftable.com	fakenews
news.vice.com	news
dcaa.mil	usgov
thecommononline.org	scientific
inquiryjournal.org	scientific
digitalcommons.wayne.edu	scientific
mx.net.au	news
ajpmonline.org	scientific
gamasutra.com	news
wom.sagepub.com	scientific
heuteonline.ch	news
neuroquantology.com	scientific
hawaii.gov	usgov
achp.gov	usgov
larena.it	news
bt.dk	news
plus.google.com	socialmedia
cochranelibrary.com	scientific
doa.alaska.gov	usgov
elpunt.cat	news
wzonline.de	news
popastro.com	scientific
fulltextrssfeed.com	news
teaherbmilksoaps.angelfire.com	commercial
feedburner.com	news
occuworld.org	blog
automattic.com	blog
nmji.in	scientific
laserfocusworld.com	scientific
crw.sagepub.com	scientific
iupac.org	scientific
deccanchronicle.com	news
coleopterist.org.uk	scientific
jpssm.org	scientific
ijoms.com	scientific
rhm.pennpress.org	scientific
stm.sciencemag.org	scientific
doc.guam.gov	usgov
provancher.qc.ca	scientific
jomfp.in	scientific
blueridgenow.com	news
psqonline.org	scientific
the-dispatch.com	news
lituanus.org	scientific
financialpost.com	news
cat.sagepub.com	scientific
imp.sagepub.com	scientific
infowars.com	clickbait|fakenews
hpp.sagepub.com	scientific
usgs.gov	usgov
wijoumed.org	scientific
lushforlife.com	fakenews
ameba.jp	socialmedia
universite.deboeck.com	scientific
gizmodo.com	news
statnews.com	news
ajog.org	scientific
glimmertrain.com	scientific
estrepublicain.fr	news
elmoudjahid.com	news
lotteryusa.com	usgov
archpedi.ama-assn.org	scientific
winnipegsun.com	news
frontline.in	news
sos.ms.gov	usgov
doc.state.ia.us	usgov
ispacs.com	scientific
thoracicmedicine.org	scientific
dlib.org	scientific
amici-thomae-mori.com	scientific
groupelavenir.net	news
nurse-practitioners-and-physician-assistants.advanceweb.com	scientific
imagejournal.org	scientific
iupress.indiana.edu	scientific
multi-science.co.uk	scientific
americansamoa.travel	usgov
humansarefree.com	clickbait|fakenews
ijp.scbaghdad.edu.iq	scientific
nrfh.colmex.mx	scientific
nypost.com	news
bioessays-journal.com	scientific
acl.hhs.gov	usgov
rsi.aip.org	scientific
ilrestodelcarlino.it	news
fanniemae.com	usgov
thestarphoenix.com	news
dmv.vermont.gov	usgov
burlingtonfreepress.com	news
economyincrisis.org	fakenews
nccdb.fmcsa.dot.gov	usgov
governor.ri.gov	usgov
iiac.cnrs.fr	scientific
thetimesoftheworld.com	fakenews
tcr.sagepub.com	scientific
anm.sagepub.com	scientific
cornellhrreview.org	scientific
joms.org	scientific
jen.sagepub.com	scientific
mountaineagle.com	news
mensstudies.info	scientific
ijdr.in	scientific
tre.sagepub.com	scientific
paloaltodailynews.com	news
ijl.oxfordjournals.org	scientific
csfs.ca	scientific
fmobserver.com	fakenews
ncte.org	scientific
legacywomenwriters.org	scientific
landesbioscience.com	scientific
pixelpost.org	blog
darkpolitricks.com	fakenews
asanet.org	scientific
actaspsiquiatria.es	scientific
davidlender.net	blog
iibf.sdu.edu.tr	scientific
okcupid.com	socialmedia
peckhamia.com	scientific
exponentcms.org	blog
jwildlifedis.org	scientific
akademiaikiado.hu	scientific
agu.org	scientific
fmpm.org	scientific
libertyvideos.org	clickbait|fakenews
threatpost.com	news
sociology.org	scientific
taylorandfrancis.com	scientific
ajae.oxfordjournals.org	scientific
freedomdaily.com	fakenews
bearbiology.com	scientific
imls.gov	usgov
fra.dot.gov	usgov
sait.oat.ts.astro.it	scientific
translationalres.com	scientific
aasmnet.org	scientific
swpa.gov	usgov
leparisien.fr	news
firstmonday.org	scientific
bib.oxfordjournals.org	scientific
weebly.com	blog
sos.la.gov	usgov
walottery.com	usgov
iucrj.org	scientific
theguardian.com	news
vessel.com	videos
pages.emerson.edu	scientific
que.es	news
dmv.ri.gov	usgov
chestjournal.org	scientific
ep.physoc.org	scientific
bto.org	scientific
respiratory-research.com	scientific
zssa.co.za	scientific
karger.com	scientific
sar.sagepub.com	scientific
combinatorics.org	scientific
bjsm.co.uk	scientific
abcnews.com	news
wisconsin.gov	usgov
world.einnews.com	blog
blackclock.org	scientific
behavioralandbrainfunctions.com	scientific
fla.sagepub.com	scientific
stackideas.com	blog
globaltimes.cn	news
whitehouse.gov	usgov
ammin.geoscienceworld.org	scientific
dhcon.ua.es	scientific
fprnradio.com	clickbait|fakenews
antiwar.com	fakenews
lorientlejour.com	news
jah.sagepub.com	scientific
pirineos.revistas.csic.es	scientific
esq.org.au	scientific
ktpress.co.uk	scientific
ijt.sagepub.com	scientific
thebostontribune.com	fakenews
thelapine.ca	satire|fakenews
hjas.org	scientific
seesmic.com	blog
uaa.alaska.edu	scientific
actamat.org	scientific
travel.state.gov	usgov
news.gc.ca	news
rse.sagepub.com	scientific
fakingnews.com	fakenews
bloodjournal.org	scientific
mohr.de	scientific
ageing.oxfordjournals.org	scientific
telegraph.co.uk	news
winningdemocrats.com	fakenews
cvi.asm.org	scientific
journals.uchastings.edu	scientific
patientslikeme.com	socialmedia
ninthletter.com	scientific
jom.sagepub.com	scientific
themuslimissue.wordpress.com	fakenews
jmq.sagepub.com	scientific
rhmjournal.org.uk	scientific
minius.webs.uvigo.es	scientific
amp-nls.org	scientific
idv.sagepub.com	scientific
vg.no	news
eur.sagepub.com	scientific
japanfocus.org	scientific
medicaid.gov	usgov
jba.sagepub.com	scientific
libertynews.com	fakenews
popsci.com	news
periodicos.ufsc.br	scientific
tsn.ca	news
antiquewireless.org	scientific
schmollersjahrbuch.de	scientific
toplas.acm.org	scientific
academie-sciences.fr	scientific
aspendailynews.com	news
paherald.sk.ca	news
walesonline.co.uk	news
cellhostandmicrobe.com	scientific
ctvisit.com	usgov
lep.co.uk	news
sfp.asso.fr	scientific
relativity.livingreviews.org	scientific
ml.oxfordjournals.org	scientific
corrections.wy.gov	usgov
dot.wisconsin.gov	usgov
bifea.revues.org	scientific
addictionjournal.org	scientific
vcj.sagepub.com	scientific
ieeeaps.org	scientific
issues.org	scientific
birdlife.fi	scientific
treehugger.com	news
readconservatives.news	fakenews
nhlottery.com	usgov
hypodiab.com	scientific
archsurg.jamanetwork.com	scientific
quizilla.com	blog
ht.no	news
cw.psypress.com	scientific
jhetchem.com	scientific
phcog.com	scientific
nordeclair.fr	news
jubilat.org	scientific
ijpsonline.com	scientific
eda.gov	usgov
aeaweb.org	scientific
dovepress.com	scientific
periscope.com	socialmedia
asmedl.aip.org	scientific
diarideterrassa.es	news
theguardian.pe.ca	news
jbc.org	scientific
newcenturytimes.com	fakenews
hbs.bishopmuseum.org	scientific
cema.edu.ar	scientific
elections.state.ri.us	usgov
annphys.org	scientific
interfaces.pubs.informs.org	scientific
humestudies.org	scientific
indiana.edu	scientific
yedioth.co.il	news
gulf-daily-news.com	news
confluenze.unibo.it	scientific
antigonishreview.com	scientific
journalofwestafricanlanguages.org	scientific
ialottery.com	usgov
state.tn.us	usgov
txlottery.org	usgov
oshrc.gov	usgov
acps.org.au	scientific
ipocan.it	scientific
archives.gov	usgov
nuevomundo.revues.org	scientific
dcsa.mil	usgov
americaoggi.info	news
azdailysun.com	news
ndreview.nd.edu	scientific
redding.com	news
doc.mo.gov	usgov
secure.ssa.gov	usgov
edmontonjournal.com	news
makeamericagreattoday.com	fakenews
balzac-etudes.paris-sorbonne.fr	scientific
mercurynews.com	news
lhomme.revues.org	scientific
ijpm.info	scientific
existenz.us	scientific
nevadalotteryresults.org	usgov
weather.gov	usgov
lagazzettadelmezzogiorno.it	news
identi.ca	socialmedia
vaccineimpact.com	blog
hhrjournal.org	scientific
mycotaxon.com	scientific
prb.sagepub.com	scientific
theassc.org	scientific
americanquarterly.org	scientific
erg.sagepub.com	scientific
nps.gov	usgov
openphysics.com	scientific
libreas.eu	scientific
trade.gov	usgov
adh.sagepub.com	scientific
video214.com	commercial
elbilad.net	news
aaohnjournal.com	scientific
texarkanagazette.com	news
l-iz.de	news
ojp.usdoj.gov	usgov
biztek.edu.pk	scientific
lacrocequotidiano.it	news
jamanak.com	news
math.nthu.edu.tw	scientific
nevadadot.com	usgov
thr.sagepub.com	scientific
theburlingamedailynews.com	news
yomiuri.co.jp	news
herodote.org	scientific
thefederalist.com	news
disclosuremedia.net	fakenews
wonkie.com	fakenews
osc.gov	usgov
intlpress.com	scientific
jad.sagepub.com	scientific
zerohedge.com	fakenews
ap3.ee	news
tt.com	news
tnvacation.com	usgov
wireless.fcc.gov	usgov
wdb.ugr.es	scientific
oonfun.com	socialmedia
uwm.edu.pl	scientific
newslo.com	satire|fakenews
kymensanomat.fi	news
civictribune.com	fakenews
journalofinfection.com	scientific
africa.ufl.edu	scientific
pubstemcell.com	scientific
harpurpalate.binghamton.edu	scientific
ww2.ceepur.org	usgov
jdsde.oxfordjournals.org	scientific
gulfnews.com	news
iaf-world.org	scientific
24heures.ch	news
auscps.com	scientific
forwardprogressives.com	fakenews
federalistpress.com	fakenews
cbsnews.com	news
eurekalert.org	news
corriere.it	news
mednet.nl	scientific
dhakatribune.com	news
cogconnected.com	news
www2.archivists.org	scientific
mmbr.asm.org	scientific
bcjournal.org	scientific
bjc.oxfordjournals.org	scientific
embojournal.npgjournals.com	scientific
intl-learnmem.cshlp.org	scientific
commerce.gov	usgov
scs.uiuc.edu	scientific
ekantipur.com	news
friendica.com	socialmedia
conservativestate.com	fakenews
ltr.sagepub.com	scientific
townhall.com	news
jasss.soc.surrey.ac.uk	scientific
nflrc.hawaii.edu	scientific
sjweb.info	scientific
cumhuriyet.com	news
elnuevoherald.com	news
cityam.com	news
bop.gov	usgov
chennaimath.org	scientific
magicvalley.com	news
ajc.com	news
ed.gov	usgov
intellectbooks.co.uk	scientific
livescience.com	news
cjche.com.cn	scientific
answers.hrsa.gov	usgov
erenlai.com	scientific
elgg.org	blog
hotlist.com	blog
sudaroli.com	news
ufaw.org.uk	scientific
rodriguesia.jbrj.gov.br	scientific
versita.com	scientific
larep.fr	news
childwelfare.gov	usgov
articles.mercola.com	fakenews
jaf.sagepub.com	scientific
ariadne.ac.uk	scientific
iowadot.gov	usgov
pikabu.ru	socialmedia
cis-sic.ca	news
shm.sagepub.com	scientific
itidjournal.org	scientific
excessiveleadseveryday.com	commercial
feb.gov	usgov
journalofnursingstudies.com	scientific
veteranstoday.com	clickbait|fakenews
directlille.com	news
visionlaunch.com	blog
cameraobscura.dukejournals.org	scientific
sewanee.edu	scientific
hillaryclinton.com	commercial
haematologica.org	scientific
tia.sagepub.com	scientific
bigstory.ap.org	blog
dailytelegraph.news.com.au	news
spandidos-publications.com	scientific
opluse.com	scientific
kentico.com	blog
osapublishing.org	scientific
novayagazeta.ru	news
rasc.ca	scientific
al-qantara.revistas.csic.es	scientific
www1.va.gov	usgov
americanreviewer.com	fakenews
inaugural.senate.gov	usgov
elect.ky.gov	usgov
usmint.gov	usgov
rusq.org	scientific
ccm.geoscienceworld.org	scientific
ara.cat	news
visitrhodeisland.com	usgov
criticalreview.com	scientific
hospitalpracticemed.com	scientific
baz.ch	news
nlrb.gov	usgov
crs.sagepub.com	scientific
elementsmagazine.org	scientific
gravelocator.cem.va.gov	usgov
betakit.com	news
nydailynews.com	news
j-alz.com	scientific
heraldtribune.com	news
singpao.com	news
gec.guam.gov	usgov
reviewofmetaphysics.org	scientific
topinfopost.com	fakenews
hmg.oxfordjournals.org	scientific
cc.com	fakenews
mt.gov	usgov
hangthebankers.com	clickbait|fakenews
ejcancer.info	scientific
theamericanindependent.wordpress.com	fakenews
addictinginfo.org	fakenews
polish-sociological-review.eu	scientific
tehelka.com	news
universum.utalca.cl	scientific
sos.ne.gov	usgov
cftc.gov	usgov
castaneajournal.org	scientific
madworldnews.com	fakenews
oxfordjournals.org	scientific
opp.sagepub.com	scientific
ijnr.ir	scientific
oregonlive.com	news
textpattern.com	blog
molbiolcell.org	scientific
pss.sagepub.com	scientific
frenchstudies.research.yale.edu	scientific
pps.sagepub.com	scientific
hq.doe.gov	usgov
jucs.org	scientific
painjournalonline.com	scientific
paris-turf.com	news
nifa.usda.gov	usgov
pole-sud.edu.umontpellier.fr	scientific
umaine.edu	scientific
newsbiscuit.com	fakenews
earthinteractions.org	scientific
ijnv.ir	scientific
surrealscoop.com	fakenews
reagancoalition.com	fakenews
ut.edu	scientific
otojournal.org	scientific
leggo.it	news
uco.es	scientific
sioc-journal.cn	scientific
hudsonreview.com	scientific
darba-eja.com	scientific
skincancer.org	news
gacetasanitaria.org	scientific
liberte-algerie.com	news
cbr.sagepub.com	scientific
fbr.sagepub.com	scientific
ftc.gov	usgov
aththa.lk	news
bdj.pensoft.net	scientific
clerk.house.gov	usgov
a16z.com	blog
rilot.com	usgov
cronicadeportiva.com	fakenews
cpsa-acsp.ca	scientific
jpeocbd.osd.mil	usgov
sil.si.edu	scientific
napavalleyregister.com	news
hrsa.gov	usgov
gulagbound.com	clickbait|fakenews
theledger.com	news
exploregeorgia.org	usgov
cell.com	scientific
nnn.co.jp	news
homooeconomicus.org	scientific
marineresourceeconomics.com	scientific
scdmvonline.com	usgov
popumed.com	scientific
hometownjournal.biz	news
ryze.com	socialmedia
ahrq.gov	usgov
edr.sagepub.com	scientific
museumvictoria.com.au	scientific
newmedia-dz.com	news
laprovinciadicremona.it	news
msnbc.com.co	fakenews
theaustralian.com.au	news
psychiatrist.com	scientific
about.usps.com	usgov
naturebase.net	scientific
webnode.com	blog
doc.state.vt.us	usgov
papers.nips.cc	scientific
magazinemieuxetre.com	scientific
complementarytherapiesinmedicine.com	scientific
letelegramme.com	news
commercialbiotechnology.com	scientific
fsijournal.org	scientific
afs.sagepub.com	scientific
ssocj.jp	scientific
icq.com	socialmedia
ijms.nova.edu	scientific
guam.gov	usgov
canada.com	news
destak.pt	news
geofisica.unam.mx	scientific
camden.rutgers.edu	scientific
phys.org	news
haydensferryreview.com	scientific
lifehacker.com	news
governor.ohio.gov	usgov
plantphysiol.org	scientific
hpy.sagepub.com	scientific
qrj.sagepub.com	scientific
bmcpublichealth.biomedcentral.com	scientific
urbanvine.co	blog
acta.astrouw.edu.pl	scientific
gas.sagepub.com	scientific
intrendtoday.com	fakenews
uspto.gov	usgov
shao.az	scientific
tfj.sagepub.com	scientific
scielo.cl	scientific
aob.oxfordjournals.org	scientific
dla.mil	usgov
astronomisches-buero-wien.or.at	scientific
juh.sagepub.com	scientific
cpa.ca	scientific
ajns.paans.org	scientific
usuhs.edu	usgov
lexpress.mu	news
bioone.org	scientific
etudesrurales.revues.org	scientific
thewalrus.ca	news
lec.sagepub.com	scientific
thetruthseeker.co.uk	fakenews
dailywire.com	fakenews
nationalguard.com	usgov
maa.org	scientific
eje.cz	scientific
ht.ly	commercial
jeg.sagepub.com	scientific
archinte.ama-assn.org	scientific
thecivilian.co.nz	fakenews
jap.aip.org	scientific
ncjrs.gov	usgov
aepp.oxfordjournals.org	scientific
archivesofpathology.org	scientific
providenceseminary.ca	scientific
paraven.net	blog
dst.sagepub.com	scientific
americansamoa.gov	usgov
themercury.com.au	news
colombiamedica.univalle.edu.co	scientific
tai2.ntu.edu.tw	scientific
drugdiscoverytoday.com	scientific
addiyar.com	news
revistas.um.es	scientific
legorafi.fr	fakenews
azdot.gov	usgov
proceedings.aip.org	scientific
trentinocorrierealpi.gelocal.it	news
conservativerefocus.com	fakenews
electrochem.org	scientific
cbc.ca	news
shtfplan.com	fakenews
landesmuseum.ktn.gv.at	scientific
jhypertension.com	scientific
globaldrugpolicy.org	scientific
jpp.sagepub.com	scientific
novell.com	blog
interstices.ac.nz	scientific
private-eye.co.uk	fakenews
catalogue.nla.gov.au	scientific
radio.userland.com	blog
dos.pa.gov	usgov
ksrevenue.org	usgov
nucleuscms.org	blog
disasterassistance.gov	usgov
conjunctions.com	scientific
dailybuzzlive.com	clickbait|fakenews
dailyprogress.com	news
birdssa.asn.au	scientific
epirev.oxfordjournals.org	scientific
nasponline.org	scientific
demographesqc.org	scientific
ingentaconnect.com	scientific
columbiajournal.org	scientific
herald.ie	news
aionlinguistica.com	scientific
mycokeys.pensoft.net	scientific
jpa.sagepub.com	scientific
cfp.ca	scientific
medphys.org	scientific
cercec.fr	scientific
smh.sagepub.com	scientific
eurheartj.oxfordjournals.org	scientific
olschki.it	scientific
grupointramuros.com	scientific
cebp.aacrjournals.org	scientific
www2.ihp.sinica.edu.tw	scientific
eurjmin.geoscienceworld.org	scientific
buzzfeed.com	news
slackjournals.com	scientific
op.se	news
jn.nutrition.org	scientific
jme.sagepub.com	scientific
saem.org	scientific
jabberwock.org.msstate.edu	scientific
publius.oxfordjournals.org	scientific
mirror.co.uk	news|fakenews
europace.oxfordjournals.org	scientific
americanlinguistics.org	scientific
revuedeneuropsychologie.com	scientific
montrealgazette.com	news
jcsdonline.org	scientific
pakistaniaat.org	scientific
ocregister.com	news
idaho.gov	usgov
change.org	commercial
orientaldaily.on.cc	news
actakoreana.kmu.ac.kr	scientific
revistapadurilor.com	scientific
online.wsj.com	news
visitusvi.com	usgov
jrm.sagepub.com	scientific
usasupreme.com	fakenews
paleopolis.rediris.es	scientific
dailyhome.com	news
smm.sagepub.com	scientific
mycologia.org	scientific
ask.fm	socialmedia
aem.asm.org	scientific
psychosomaticsjournal.org	scientific
fnb.sagepub.com	scientific
jfe.rochester.edu	scientific
anuariosatlanticos.casadecolon.com	scientific
dnews.com	news
giornaledibergamo.com	news
americanriverreview.wordpress.com	scientific
cnsnews.com	blog
kiltr.com	socialmedia
endoftheamericandream.com	fakenews
conservationandsociety.org	scientific
european-journal.org	scientific
journalofsubstanceabusetreatment.com	scientific
usnwc.edu	scientific
ajconline.org	scientific
ncscooper.com	fakenews
mtq.sagepub.com	scientific
j.sinap.ac.cn	scientific
sos.mo.gov	usgov
verlag-hanshuber.com	scientific
oceanservice.noaa.gov	usgov
ajps.org	scientific
sut.org.uk	scientific
irishexaminer.com	news
infostormer.com	fakenews
blog.smw.ch	scientific
thieme-connect.com	scientific
crops.org	scientific
linguisticsociety.org	scientific
ubishops.ca	scientific
jpalliativecare.com	scientific
nikkei.com	news
flickr.com	socialmedia|videos
buffalonews.com	news
joomla.org	blog
upworthy.com	blog
pediatricnursing.net	scientific
cje.oxfordjournals.org	scientific
researchinlearningtechnology.net	scientific
wiz.pl	scientific
justice.gov	usgov
copyright.gov	usgov
usmarshals.gov	usgov
dev.biologists.org	scientific
cullmantimes.com	news
igme.es	scientific
modernhealthcare.com	news
corrections.az.gov	usgov
jbiomedsci.com	scientific
tijd.be	news
seismosoc.org	scientific
plantnet.rbgsyd.nsw.gov.au	scientific
sos.wv.gov	usgov
fw.to	commercial
europetodayonline.com	news
fictioninc.com	scientific
independent.co.uk	news
sysbio.oxfordjournals.org	scientific
bangladeshtribune.com	news
nationmultimedia.com	news
univ-orleans.fr	scientific
nj.com	news
smr.sagepub.com	scientific
oea.gov	usgov
sino-platonic.org	scientific
soas.ac.uk	scientific
liebertpub.com	scientific
unisa.ac.za	scientific
em.doe.gov	usgov
espacepolitique.revues.org	scientific
publichealthreports.org	scientific
wileyonlinelibrary.com	scientific
doa.state.nc.us	usgov
sti.bmj.com	scientific
primorski.eu	news
rcjournal.com	scientific
mmc.gov	usgov
zsf.jcu.cz	scientific
lcweb.loc.gov	usgov
fr-online.de	news
healthimpactnews.com	fakenews
mobilesyrup.com	news
szf-jfs.org	scientific
asor.org	scientific
africanbirdclub.org	scientific
ethicsandinternationalaffairs.org	scientific
corrierenazionale.it	news
isp.oxfordjournals.org	scientific
loudblog.com	blog
noesis.evansville.edu	scientific
vactruth.com	blog
sott.net	fakenews
liberation.fr	news
libe.ma	news
wdcrobcolp01.ed.gov	usgov
canadiandimension.com	fakenews
seikyonet.jp	news
onomastics.ru	scientific
sed.sagepub.com	scientific
udppc.asso.fr	scientific
egov.com	usgov
econjwatch.org	scientific
aasc.ucla.edu	scientific
torontosportsmedia.com	news
radikal.com.tr	news
mayoclinic.org	news
ima.org.il	scientific
esj.sagepub.com	scientific
gopthedailydose.com	fakenews
cloud-cuckoo.net	scientific
jco-online.com	scientific
nd.gov	usgov
pakistantoday.com.pk	news
pravo.novinky.cz	news
johnnyrobish.com	fakenews
corpweb1.dfas.mil	usgov
ec.asm.org	scientific
ice.gov	usgov
suntimes.com	news
trj.sagepub.com	scientific
ajph.org	scientific
nga.mil	usgov
barenakedislam.com	fakenews
peerj.com	scientific
l-actu.fr	news
dailynews.lk	news
azdoa.gov	usgov
healthfinder.gov	usgov
abap.co.in	scientific
psycho-clinique.org	scientific
thehackernews.com	blog
jas.sagepub.com	scientific
hapr.org	scientific
kenyonreview.org	scientific
gia.edu	scientific
ssab.gov	usgov
newizv.ru	news
chronicle.su	clickbait|fakenews
lexpress.ch	news
web.ita.doc.gov	usgov
iol.co.za	news
trans-int.org	scientific
nd.edu	scientific
cwins.wpi.edu	scientific
medicalnewstoday.com	news
journals.hil.unb.ca	scientific
hydrology-and-earth-system-sciences.net	scientific
archneur.jamanetwork.com	scientific
jpeds.com	scientific
harrassowitz-verlag.de	scientific
marineornithology.org	scientific
sacaaa.org	scientific
geology.cz	scientific
clinsci.org	scientific
lup.sagepub.com	scientific
sprotspickle.com	fakenews
thedailysheeple.com	clickbait|fakenews
fsp.idaho.gov	usgov
lopinion.fr	news
jte.sagepub.com	scientific
eluniverso.com	news
lokprashna.com	news
chi.sagepub.com	scientific
ravelry.com	socialmedia
lrt.sagepub.com	scientific
federalreserveconsumerhelp.gov	usgov
washingtonexaminer.com	news|fakenews
mhra.org.uk	scientific
triblive.com	news
cjasn.asnjournals.org	scientific
scipharm.at	scientific
ems-ph.org	scientific
buenosairesherald.com	news
rosenbergesellier.it	scientific
goang.com	usgov
coasttocoastam.com	clickbait|fakenews
aaiddjournals.org	scientific
theshovel.com.au	fakenews
bbci.co.uk	news
metro.co.uk	news
fb.me	commercial
ewao.com	fakenews
bbc.com	news
jpr.sagepub.com	scientific
bentham.org	scientific
marinersoftware.com	blog
cria.polis.cam.ac.uk	scientific
iaf.gov	usgov
kyklos-review.ch	scientific
lasphys.com	scientific
wr.de	news
lematin.ma	news
cmj.org	scientific
molecularbrain.com	scientific
lactualitechimique.org	scientific
abcnews.go.com	news
fws.gov	usgov
virginia.gov	usgov
blackwellpublishing.com	scientific
abqjournal.com	news
charlestonco.com	scientific
thepeninsulaqatar.com	news
uthayan.com	news
ermt.net	scientific
journalpioneer.com	news
srhlf.free.fr	scientific
export.gov	usgov
ojrd.com	scientific
nuovavenezia.gelocal.it	news
thebeaverton.com	fakenews
bea.gov	usgov
ucoz.com	blog
ibr-bbr.org	scientific
chimia.ch	scientific
royalgazette.com	news
edu.zndxzk.com.cn	scientific
gsp.sagepub.com	scientific
lecourrier.ch	news
medsci.org	scientific
rop.sagepub.com	scientific
jacionline.org	scientific
asmjournals.org	scientific
journals.lww.com	scientific
teknoscienze.com	scientific
openworld.gov	usgov
uhpress.hawaii.edu	scientific
jis.sagepub.com	scientific
jneurosci.org	scientific
thegatewaypundit.com	fakenews
jstatsoft.org	scientific
usbg.gov	usgov
clinicalpain.com	scientific
blogtalkradio.com	news
jhc.sagepub.com	scientific
himalmag.com	scientific
rsnz.natlib.govt.nz	scientific
aipcnet.it	scientific
agalmaweb.org	scientific
elcvia.cvc.uab.es	scientific
ajs.sagepub.com	scientific
fcsic.gov	usgov
bukedde.co.ug	news
complex-systems.com	scientific
vigilantcitizen.com	fakenews
ress.revues.org	scientific
improveirs.org	usgov
flipboard.com	blog
dothaneagle.com	news
cpmt.org	scientific
nq.oxfordjournals.org	scientific
fema.gov	usgov
naturalhistorymag.com	scientific
africametro.com	fakenews
lasprovincias.es	news
tsup.truman.edu	scientific
thekhayaban.com	scientific
misq.org	scientific
leeds.ac.uk	scientific
jea.sagepub.com	scientific
awazetribune.com	fakenews
gov.mp	usgov
florabase.dec.wa.gov.au	scientific
edm.sagepub.com	scientific
lepetitquotidien.fr	news
aebioetica.org	scientific
dgs.virginia.gov	usgov
ghpjournal.com	scientific
periscope.tv	socialmedia
humanisme-et-entreprise.asso-web.com	scientific
steiner-verlag.de	scientific
msp.org	scientific
nationofchange.org	fakenews
mcx.sagepub.com	scientific
jee.org	scientific
grasasyaceites.revistas.csic.es	scientific
louisianalottery.com	usgov
newelectronics.co.uk	scientific
ijcaonline.org	scientific
lecho.be	news
americansamoaelectionoffice.org	usgov
alcatel-lucent.com	scientific
ich.gov	usgov
jp.physoc.org	scientific
jnnp.bmj.com	scientific
aaf.sagepub.com	scientific
eupjournals.com	scientific
elacil.com	news
nwcouncil.org	usgov
pdk.sagepub.com	scientific
jic.sagepub.com	scientific
azsos.gov	usgov
posterous.com	blog
jid.oxfordjournals.org	scientific
sociologieetsocietes.ca	scientific
clinicaltherapeutics.com	scientific
web.uvic.ca	scientific
nanophotonics.spiedigitallibrary.org	scientific
macejournal.org	scientific
chicagoreview.org	scientific
representations.org	scientific
conservativefrontline.com	fakenews
globalresearch.ca	clickbait|fakenews
maney.co.uk	scientific
informs.org	scientific
diariojaen.es	news
frenchreview.frenchteachers.org	scientific
mundodeportivo.com	news
actacardiologica.be	scientific
pentictonherald.ca	news
mcc.gov	usgov
aa.uwpress.org	scientific
dbm.sagepub.com	scientific
wordpress.org	blog
opticalengineering.spiedigitallibrary.org	scientific
schlegel-gesellschaft.de	scientific
hum.huji.ac.il	scientific
skyandtelescope.com	scientific
irs.sagepub.com	scientific
hol.sagepub.com	scientific
archeosciences.revues.org	scientific
wwwmath.uni-muenster.de	scientific
newschief.com	news
app.pan.pl	scientific
cairns.com.au	news
levante-emv.com	news
jim.se	scientific
mrt.com	news
mobot.org	scientific
eia.gov	usgov
mmr.sagepub.com	scientific
inorgsynth.com	scientific
papyrology.org	scientific
rei.revues.org	scientific
newyorker.com	news
criticalcare.theclinics.com	scientific
therecord.com	news
ajtr.org	scientific
newscorpse.com	fakenews
dif.unige.it	scientific
pjss.iscte.pt	scientific
downtrend.com	fakenews
epx.sagepub.com	scientific
rsif.royalsocietypublishing.org	scientific
posta.com.tr	news
hepatitisbannual.org	scientific
ijoem.com	scientific
jni-journal.com	scientific
winnipegfreepress.com	news
darpa.mil	usgov
boa.sd.gov	usgov
econtheory.org	scientific
nsq.sagepub.com	scientific
tdg.ch	news
apple.com	commercial
exploreminnesota.com	usgov
angrypatriotmovement.com	fakenews
ts.lemoyne.edu	scientific
rita.dot.gov	usgov
floridamedia.org	scientific
investmentwatchblog.com	fakenews
aemnp.eu	scientific
pdcnet.org	scientific
flra.gov	usgov
scitation.aip.org	scientific
army.mil	usgov
act.org	usgov
informahealthcare.com	scientific
danskestudier.dk	scientific
sylwan.ibles.waw.pl	scientific
dailygleaner.canadaeast.com	news
ijmr.org.in	scientific
conbio.org	scientific
beforeitsnews.com	clickbait|fakenews
sax.sagepub.com	scientific
linguistic-typology.org	scientific
truthfrequencyradio.com	clickbait|fakenews
krisis.eu	scientific
ijo.in	scientific
internationalemergencynursing.com	scientific
postroadmag.com	scientific
libertyaction.org	commercial
host.madison.com	news
hsb.sagepub.com	scientific
biometrische-gesellschaft.de	scientific
ssh.dukejournals.org	scientific
hw.oeaw.ac.at	scientific
courierpress.com	news
esa.doc.gov	usgov
selmatimesjournal.com	news
myzonetoday.com	fakenews
wox.sagepub.com	scientific
illinois.gov	usgov
arqarqt.revistas.csic.es	scientific
pra.aps.org	scientific
aece.ro	scientific
scm.sagepub.com	scientific
ijlm.net	scientific
blog.de	blog
scielo.org.ar	scientific
kingworldnews.com	fakenews
whitepower.com	fakenews
thereporterz.com	fakenews
jsis.washington.edu	scientific
astroreview.com	scientific
doc.wa.gov	usgov
sil.org	scientific
threepercenternation.com	fakenews
mtp.hum.ku.dk	scientific
iumj.indiana.edu	scientific
eltiempo.com	news
jamesmadison.scholarsapply.org	usgov
rmp.aps.org	scientific
paleo.revues.org	scientific
bonewitz.de	scientific
hungermtn.org	scientific
redgage.com	commercial
hbl.fi	news
gangstergovernment.com	fakenews
naturalnews.com	clickbait|fakenews
rsw.sagepub.com	scientific
nodisinfo.com	clickbait|fakenews
jgp.rupress.org	scientific
beme.com	socialmedia|videos
travelks.com	usgov
rsmas.miami.edu	scientific
jmcs.org.mx	scientific
medicalimaging.spiedigitallibrary.org	scientific
timesdaily.com	news
utpress.utexas.edu	scientific
entrepreneuriat.com	scientific
lefigaropatrimoine.fr	news
people.hsc.edu	scientific
omnifeed.com	news
ellitoral.com	news
msmonographs.org	scientific
das.nh.gov	usgov
transportation.wv.gov	usgov
glossynews.com	fakenews
eymj.org	scientific
saultstar.com	news
endingthefed.com	fakenews
sh.st	commercial
clincancerres.aacrjournals.org	scientific
ecr.sagepub.com	scientific
salongo.best.cd	news
doccs.ny.gov	usgov
eforms.doi.gov	usgov
alaska.gov	usgov
riojournal.com	scientific
noiseandhealth.org	scientific
capebretonpost.com	news
aaahq.org	scientific
impublications.com	scientific
revistasonline.inap.es	scientific
zeus.fltr.ucl.ac.be	scientific
americanlookout .com	fakenews
sth.sagepub.com	scientific
hitfix.com	news
mocospace.com	socialmedia
civilisations.revues.org	scientific
flhsmv.gov	usgov
aac.asm.org	scientific
elektronika.orf.pl	scientific
wjn.sagepub.com	scientific
dfas.mil	usgov
asih.org	scientific
dir.commerce.gov	usgov
israelexplorationsociety.huji.ac.il	scientific
medpac.gov	usgov
leicestermercury.co.uk	news
airforce.com	usgov
volkskrant.nl	news
cracked.com	fakenews
tmt.sagepub.com	scientific
egov.uscis.gov	usgov
mo.gov	usgov
ieee-sensors.org	scientific
neh.gov	usgov
orkut.com	socialmedia
journals.rcni.com	scientific
sos.arkansas.gov	usgov
architecture.yale.edu	scientific
preservationnation.org	scientific
pbsociety.org.pl	scientific
nass.usda.gov	usgov
jbiol.com	scientific
dnaresearch.oxfordjournals.org	scientific
bmo.sagepub.com	scientific
ildomani.it	news
politicalblindspot.com	clickbait|fakenews
msn.com	blog
dagbladet.se	news
cato.org	scientific
democracynow.org	fakenews
jcs.sagepub.com	scientific
indianjcancer.com	scientific
inquisitr.com	fakenews
dcor.state.ga.us	usgov
floramontiberica.wordpress.com	scientific
ushmm.org	usgov
rp-online.de	news
hogrefe.com	scientific
abpo.revues.org	scientific
physiotherapy.asn.au	scientific
aror.orient.cas.cz	scientific
660news.com	news
elsalvador.com	news
rlv.revues.org	scientific
thejns.org	scientific
jcasonline.com	scientific
morgenpost.de	news
frontiers.osu.edu	scientific
dailydot.com	blog
frtib.gov	usgov
historischegaerten.de	scientific
seepuertorico.com	usgov
bms.ulb.ac.be	scientific
journal.frontiersin.org	scientific
acadsci.fi	scientific
petrology.oxfordjournals.org	scientific
bsw.org	scientific
whowhatwhy.org	fakenews
sydowia.at	scientific
www-gewi.kfunigraz.ac.at	scientific
ilcentro.gelocal.it	news
ildomanidibologna.it	news
thewrap.com	blog
dailytownsman.com	news
jpma.org.pk	scientific
home.vef.gov	usgov
sankei.jp	news
dreamwidth.org	blog
sol.lu.se	scientific
academicpedsjnl.net	scientific
visitmaine.com	usgov
contact.darpa.mil	usgov
bighairynews.com	fakenews
truthfeed.com	fakenews
uc.pt	scientific
money.cnn.com	news
iai.asm.org	scientific
oregon.gov	usgov
cnsspectrums.com	scientific
cor.mt.gov	usgov
jhrsonline.org	scientific
abilityone.gov	usgov
uscis.gov	usgov
topekasnews.com	fakenews
kluwerlawonline.com	scientific
democraticunderground.com	fakenews
moh.sagepub.com	scientific
clinicalmicrobiologyandinfection.com	scientific
20min.ch	news
consumer.ftc.gov	usgov
health.com	news
cairn.info	scientific
adisonline.com	scientific
fonduaunoir44.blogspot.com	scientific
ft.lk	news
cie.acm.org	scientific
thestar.com	news
rehab.research.va.gov	scientific
cyprus-mail.com	news
dmvnv.com	usgov
dinamina.lk	news
leconomiepolitique.fr	scientific
giornaledibrescia.it	news
jb.asm.org	scientific
yalescientific.org	scientific
revistas.ucm.es	scientific
content.karger.com	scientific
ped.sagepub.com	scientific
southernspaces.org	scientific
eds.ieee.org	scientific
mss.sagepub.com	scientific
bmcneurol.biomedcentral.com	scientific
larouchepub.com	fakenews
s.einnews.com	blog
sa2.www4.irs.gov	usgov
limpartial.ch	news
noticiaja.rac.com.br	news
eaglerising.com	fakenews
psy-journal.com	scientific
elections.state.md.us	usgov
scmp.com	news
dailydiscord.com	fakenews
medium.com	blog
scirp.org	scientific
rocskincare.com	commercial
feeds.feedburner.com	blog
fgdc.gov	usgov
jfsc.ndu.edu	usgov
postalinspectors.uspis.gov	usgov
ilmanifesto.info	news
borowitzreport.com	fakenews
northamericanreview.org	scientific
wrc.org.za	scientific
dsca.mil	usgov
in.com	news
corriereromagna.it	news
revistas.uv.cl	scientific
jcircadianrhythms.com	scientific
annclinlabsci.org	scientific
sajs.co.za	scientific
eurogamer.net	news
scielo.org.co	scientific
yalejournal.org	scientific
ac.gobierno.pr	usgov
uniblogs.org	blog
torontosun.com	news
publichealthjrnl.com	scientific
filcasop.flu.cas.cz	scientific
""	fakenews
hgtv.ca	news
journalofdemocracy.org	scientific
recode.net	news
occ.treas.gov	usgov
revolutions2040.com	fakenews
killscreendaily.com	news
sbsun.com	news
travelok.com	usgov
bmj.com	scientific
arctic.gov	usgov
jfcom.mil	usgov
bgbm.org	scientific
jstor.org	scientific
intrepidreport.com	fakenews
pbi.sagepub.com	scientific
bsas.org.uk	scientific
ribbs.usps.gov	usgov
alpinejournal.org.uk	scientific
mequarterly.org	scientific
redwoodcitydailynews.com	news
libraries.slu.edu	scientific
aja.sagepub.com	scientific
gazettelive.co.uk	news
reuters.com	news
institutions.ville-geneve.ch	scientific
research.ibm.com	scientific
cancerjournal.net	scientific
connections-qj.org	scientific
genesandnutrition.biomedcentral.com	scientific
lingv.ro	scientific
csb.gov	usgov
folha.com.br	news
jes.ecsdl.org	scientific
secure.jten.mil	usgov
todaydailynews.com	news
reviewjournal.com	news
dukeupress.edu	scientific
cbj.ca	news
commissaries.com	usgov
aornjournal.org	scientific
hildesheimer-allgemeine.de	news
rhodora.org	scientific
journals.tubitak.gov.tr	scientific
usajobs.gov	usgov
ijmm.org	scientific
sd.gov	usgov
ad.nl	news
americanpatriotdaily.com	fakenews
corrieredelmezzogiorno.corriere.it	news
sos.iowa.gov	usgov
blogsome.com	blog
trivium.revues.org	scientific
collective-evolution.com	fakenews
jonmd.com	scientific
cuadernos.info	scientific
lrjournal.com	scientific
dcourier.com	news
brjpharmacol.org	scientific
consciouslifenews.com	clickbait|fakenews
orbistertius.unlp.edu.ar	scientific
pnas.org	news|scientific
tou.sagepub.com	scientific
cyberpresse.ca	news
arj.sagepub.com	scientific
malariajournal.com	scientific
persianblog.ir	socialmedia
berghahnbooks.com	scientific
nc-educationlottery.org	usgov
jcheminf.springeropen.com	scientific
jit.sagepub.com	scientific
irc-galleria.net	socialmedia
economics-sociology.eu	scientific
medicine.yale.edu	scientific
usj.sagepub.com	scientific
larsg.fr	scientific
letemps.com.tn	news
jmi.sagepub.com	scientific
annalspc.com	scientific
neilsonjournals.com	scientific
rightalerts.com	fakenews
sri.sagepub.com	scientific
acus.gov	usgov
fromthetrenchesworldreport.com	fakenews
199.44.84.82	usgov
rjb.revistas.csic.es	scientific
etcanada.com	news
crj.sagepub.com	scientific
ajp.amjpathol.org	scientific
kansascity.com	news
illuminati-news.com	fakenews
generalservices.state.nm.us	usgov
vaxxedthemovie.com	commercial
lottery.az.gov	usgov
360.yahoo.com	blog
baywood.com	scientific
cfpb.gov	usgov
hjb.sagepub.com	scientific
wearechange.org	fakenews
jar.sagepub.com	scientific
ijoca.com	scientific
eurpub.oxfordjournals.org	scientific
revueinternationalepme.com	scientific
pigment.org	scientific
louisiana.gov	usgov
journals.sfu.ca	scientific
sec.state.vt.us	usgov
idescat.cat	scientific
decaturdaily.com	news
naftemporiki.gr	news
politicalcult.com	fakenews
truth.tv	blog
dps.state.ok.us	usgov
odt.co.nz	news
africa-spectrum.org	scientific
biotechniques.com	scientific
nsf.gov	usgov
ushealthyadvisor.com	fakenews
jornada.unam.mx	news
tsp.gov	usgov
nlm.nih.gov	usgov
promotedstories.com	commercial
ruhrnachrichten.de	news
movabletype.org	blog
janmorganmedia.com	fakenews
tfai.vu.lt	scientific
seminariomatematico.dm.unito.it	scientific
dvhn.nl	news
itaglive.com	satire|fakenews
ceaccp.oxfordjournals.org	scientific
fmc.gov	usgov
alchourouk.com	news
connect.ga.gov	usgov
autoblog.com	blog
genomebiology.com	scientific
umes.edu	scientific
scvotes.org	usgov
currentscience.ac.in	scientific
eutimes.net	fakenews
sos.state.nm.us	usgov
seattleorganicrestaurants.com	commercial
nicematin.fr	news
blacpma.usach.cl	scientific
rsbl.royalsocietypublishing.org	scientific
nlai.ir	scientific
satirewire.com	fakenews
actazool.nhmus.hu	scientific
dailymail.co.uk	news
psypress.com	scientific
alabamavotes.gov	usgov
icie.zkm.de	scientific
walkingtimes.com	fakenews
rms.medhyg.ch	scientific
systematicreviewsjournal.com	scientific
massrmv.com	usgov
huffingtonpost.it	news
usdoj.gov	usgov
revistas.upr.edu	scientific
fossil.energy.gov	usgov
news4ktla.com	fakenews
uspoliticslive.com	fakenews
wetpaint.com	blog
pus.unistra.fr	scientific
mdb.cast.ru	scientific
osha.gov	usgov
ojs.letras.up.pt	scientific
zootfeed.com	fakenews
scribd.com	blog
dailycurrant.com	fakenews
bigadda.com	blog
annals.ensae.fr	scientific
209.235.208.145	scientific
giornaledicalabria.net	news
bjcn.co.uk	scientific
em.oxfordjournals.org	scientific
kaunodiena.lt	news
fellowshipoftheminds.com	fakenews
rsabg.org	scientific
mineralogicalassociation.ca	scientific
blacklistednews.com	fakenews
uclm.es	scientific
home.ewha.ac.kr	scientific
theiet.org	scientific
cvc.cervantes.es	scientific
pro.sagepub.com	scientific
content.sabinet.co.za	scientific
or.journal.informs.org	scientific
notrevoie.com	news
lepotentielonline.com	news
us.army.mil	usgov
revista.inecc.gob.mx	scientific
blackgenocide.org	fakenews
point24.lu	news
brantfordexpositor.ca	news
mollus.nl	scientific
gamingpost.ca	news
diariolasamericas.com	news
crazyhorse.cofc.edu	scientific
americanthinker.com	blog
annonc.oxfordjournals.org	scientific
equinoxjournals.com	scientific
hilltimes.com	news
adc.arkansas.gov	usgov
pbgc.gov	usgov
yachtingmagazine.com	scientific
maik.ru	scientific
cnr.sagepub.com	scientific
glycob.oxfordjournals.org	scientific
hararetribune.com	news
singtao.ca	news
dailyheadlines.net	fakenews
ease.org.uk	scientific
themadisonmisnomer.com	fakenews
wz.de	news
eje-online.org	scientific
cnet.com	news
imss.nl	scientific
ferc.gov	usgov
upi.com	news
eveningexpress.co.uk	news
nsd.rdc.noaa.gov	usgov
tools.usps.com	usgov
independent.ie	news
lemauricien.com	news
independent.org	scientific
trouw.nl	news
annals.in	scientific
trueactivist.com	fakenews
visitdelaware.com	usgov
conservativetribune.com	fakenews
directory.faa.gov	usgov
elnortedecastilla.es	news
journalofpaleontology.org	scientific
uscgboating.org	usgov
asmedl.org	scientific
atvb.ahajournals.org	scientific
indianforester.org	scientific
capnews.com	fakenews
presstelegram.com	news
bst.sagepub.com	scientific
lww.com	scientific
jmp.org.in	scientific
marquette.edu	scientific
macworld.com	news
msegov.com	usgov
lefigaro.fr	news
simh.seele-brennt.com	scientific
annals.com	scientific
info.emeraldinsight.com	scientific
lwbooks.co.uk	scientific
human-resources-health.com	scientific
usuhs.mil	usgov
dailynews.co.zw	news
pen.sagepub.com	scientific
comjnl.oxfordjournals.org	scientific
amub.be	scientific
groupes.polymtl.ca	scientific
macleans.ca	news
freewebs.com	blog
imrn.oxfordjournals.org	scientific
thefreepatriot.org	fakenews
niams.nih.gov	usgov
ecologyandsociety.org	scientific
rsaa.org.uk	scientific
harvardbusiness.org	news
conferencecalltranscripts.org	commercial
samhsa.hhs.gov	usgov
elsevier.es	scientific
tcrecord.org	scientific
bmjopen.bmj.com	scientific
oecd.org	scientific
kylottery.com	usgov
dmv.ca.gov	usgov
emis.de	scientific
merip.org	scientific
mhj.net.au	scientific
degruyter.com	scientific
toms.acm.org	scientific
mediamatters.org	fakenews
aip.de	scientific
marad.dot.gov	usgov
confluence.ou.edu	scientific
mayoclinicproceedings.org	scientific
jiacam.org	scientific
havre-libre.fr	news
elcorreoweb.es	news
dep.state.fl.us	usgov
jco.org	scientific
phytokeys.pensoft.net	scientific
governor.mo.gov	usgov
lephareonline.net	news
britac.ac.uk	scientific
rha.revues.org	scientific
mbio.asm.org	scientific
recalls.gov	usgov
iospress.nl	scientific
peninsulaclarion.com	news
nhtsa.gov	usgov
gallica2.bnf.fr	scientific
msp.warwick.ac.uk	scientific
bignuggetnews.com	fakenews
actamathematica.org	scientific
abqtrib.com	news
lmcs-online.org	scientific
dionee.org	scientific
mtjournal.ru	scientific
azgovernor.gov	usgov
linkagoal.com	socialmedia
imeche.org	scientific
supremepatriot.com	fakenews
socialiststudies.com	scientific
oa.mo.gov	usgov
woodstocksentinelreview.com	news
rd.usda.gov	usgov
uel.ac.uk	scientific
march-against-monsanto.com	blog
ffiec.gov	usgov
travelsouthdakota.com	usgov
dailynews.com	news
ctlottery.org	usgov
rmiembassyus.org	usgov
vanguardia.com	news
liberaldarkness.com	fakenews
fdlreporter.com	news
ww3.freddiemac.com	usgov
freedomoutpost.com	fakenews
nimh.nih.gov	usgov
goviamedia.com	scientific
materialstoday.com	scientific
kaleva.fi	news
dojmt.gov	usgov
irs.gov	usgov
fao.org	scientific
ncra.tifr.res.in	scientific
stcatharinesstandard.ca	news
mn.gov	usgov
ams.usda.gov	usgov
forums.nexopia.com	socialmedia
mej.sagepub.com	scientific
coloradoreview.colostate.edu	scientific
tps.sagepub.com	scientific
businessweek.com	news
edrv.endojournals.org	scientific
nnsa.energy.gov	usgov
ustaxcourt.gov	usgov
dmv.utah.gov	usgov
yaleeconomicreview.org	scientific
noaa.gov	usgov
worldtruth.tv	clickbait|fakenews
davidsonia.org	scientific
tpa.sagepub.com	scientific
elections.virginia.gov	usgov
ginniemae.gov	usgov
ejpc.eu.com	scientific
timesofoman.com	news
dailybreeze.com	news
handelsblatt.com	news
deadline.com	news
blogher.com	blog
stance.iweb.bsu.edu	scientific
reuters.us.feedsportal.com	news
gbr.sagepub.com	scientific
medpagetoday.com	news
dsshelp.org	usgov
dc.gov	usgov
cowgernation.com	fakenews
law.umich.edu	scientific
arabstudiesquarterly.plutojournals.org	scientific
soup.io	blog
gametrailers.com	news
nasa.gov	usgov|news
jsantisemitism.org	scientific
wilottery.com	usgov
governor.wyo.gov	usgov
highbeam.com	scientific
jusfc.gov	usgov
pubs.rsc.org	scientific
chjs.soche.cl	scientific
ibtimes.co.uk	news
governor.iowa.gov	usgov
nationalreview.com	news
promodj.com	socialmedia
bja.oxfordjournals.org	scientific
qsjournal.com.cn	scientific
cffc.navy.mil	usgov
acta-zoologica-bulgarica.eu	scientific
tulsamedicalspa.com	commercial
theduran.com	fakenews
emeraldinsight.com	scientific
biosoc.pk	scientific
dailymotion.com	videos
the-japan-news.com	news
institucional.us.es	scientific
sajg.geoscienceworld.org	scientific
molecularpain.com	scientific
openjournals.libs.uga.edu	scientific
fupress.net	scientific
estadistica.unal.edu.co	scientific
tehrantimes.com	news
relaquim.com	scientific
occmed.oxfordjournals.org	scientific
iab.sagepub.com	scientific
uscg.mil	usgov
gov.alaska.gov	usgov
dailyheraldtribune.com	news
revistahistoriapsicologia.es	scientific
mvd.usace.army.mil	usgov
araldodellospettacolo.it	news
pubblicogiornale.it	news
liberalquotidiano.it	news
inquirer.com.ph	news
public.navy.mil	usgov
aphis.usda.gov	usgov
therundownlive.com	clickbait|fakenews
udall.gov	usgov
politicalvelcraft.org	fakenews
liberoquotidiano.it	news
molecularautism.com	scientific
jca.sagepub.com	scientific
mtt.org	scientific
vivelohoy.com	news
ello.co	socialmedia
cuonline.ncua.gov	usgov
feedsportal.com	news
gov.texas.gov	usgov
cde.sagepub.com	scientific
lidovky.cz	news
electrochemsci.org	scientific
ajsonline.org	scientific
platinummetalsreview.com	scientific
tagesspiegel.de	news
grist.org	news
ideas.live.com	blog
poeticstoday.dukejournals.org	scientific
jaa.sagepub.com	scientific
stroke.ahajournals.org	scientific
societabotanicaitaliana.it	scientific
popsugar.com	news
lib.slu.edu	scientific
aei.sagepub.com	scientific
derechoycienciapolitica.cl	scientific
pacificaffairs.ubc.ca	scientific
las.sagepub.com	scientific
indianjgastro.com	scientific
mandestudies.org	scientific
aacnclinicalissues.com	scientific
georgia.gov	usgov
sites.google.com	usgov|scientific
archpsyc.jamanetwork.com	scientific
publica.webs.ull.es	scientific
irct.org	scientific
nicic.gov	usgov
magazine.ieee-pes.org	scientific
chemanager.com	scientific
telegraphindia.com	news
revistahistoriamoderna.ua.es	scientific
ashjournal.com	scientific
meteoriticalsociety.org	scientific
program	usgov
collectivelyconscious.net	fakenews
healio.com	scientific
erx.sagepub.com	scientific
iasc-culture.org	scientific
kjs.re.kr	scientific
cbp.gov	usgov
britastro.org	scientific
plosone.org	scientific
cadillacnews.com	news
mesharpe.metapress.com	scientific
nepjoph.org.np	scientific
apsjournals.apsnet.org	scientific
helv.wiley.com	scientific
bioingenioren.no	scientific
boem.gov	usgov
federalreserve.gov	usgov
gov.georgia.gov	usgov
ai.wyo.gov	usgov
vaxxed.com	blog
elheraldo.com.co	news
senate.gov	usgov
businessdayonline.com	news
medecinesciences.org	scientific
americannews.com	fakenews
elections.utah.gov	usgov
jos.oxfordjournals.org	scientific
nirc.nanzan-u.ac.jp	scientific
movim.eu	blog
thetimes.co.uk	news
h-net.org	scientific
journals.elsevierhealth.com	scientific
typepad.com	blog
nj.gov	usgov
fiscal.treasury.gov	usgov
empiresports.co	satire|fakenews
rollingstone.com	news
quarterlywest.com	scientific
onsugar.com	blog
jardincanario.org	scientific
cardiac-nursing.co.uk	scientific
tmz.com	news
ttl.fi	scientific
chas-daily.com	news
unco.edu	scientific
inthealth.oxfordjournals.org	scientific
cops.usdoj.gov	usgov
cvironline.org	scientific
aes.sagepub.com	scientific
rss.sagepub.com	scientific
rss.org.uk	scientific
weeklystandard.com	news
jb.ul.pt	scientific
ng.army.mil	usgov
nsku.org.ua	scientific
portal.ct.gov	usgov
sputniknews.com	fakenews
cmr.berkeley.edu	scientific
xxx.sagepub.com	scientific
physics.aps.org	scientific
hud.gov	usgov
mlj.miis.edu	scientific
ejw.sagepub.com	scientific
chem.uw.edu.pl	scientific
hta.ac.uk	scientific
ijbnpa.org	scientific
cap-news.com	fakenews
theantimedia.org	fakenews
experiencewa.com	usgov
publico.es	news
sensesofcinema.com	scientific
slate.com	news
acns.org	scientific
dmd.aspetjournals.org	scientific
catalog.gpo.gov	usgov
res.oxfordjournals.org	scientific
latempete.info	news
visit-palau.com	usgov
kp.ru	news
cos.sagepub.com	scientific
alliedacademies.org	scientific
pro.tsv.fi	scientific
e-spania.revues.org	scientific
mississippi.gov	usgov
intertrends.ru	scientific
ctj.sagepub.com	scientific
staradvertiser.com	news
com.de	fakenews
lansi-savo.fi	news
particlenews.com	blog
laprensa.com.ar	news
dennismichaellynch.com	fakenews
archivoespa√±oldearte.revistas.csic.es	scientific
jmt.sagepub.com	scientific
macpac.gov	usgov
greenbranch.com	scientific
feeds.huffingtonpost.com	news
arp.sagepub.com	scientific
es.viadeo.com	socialmedia
ufn.ru	scientific
tuscaloosanews.com	news
vaw.sagepub.com	scientific
xula.edu	scientific
snip.ly	commercial
editorialmanager.com	scientific
nieuwsblad.be	news
ntvg.nl	scientific
nationalservice.gov	usgov
votecnmi.gov.mp	usgov
bhs.econ.census.gov	usgov
globalnews.ca	news
nct.com	fakenews
timesrecordnews.com	news
abendzeitung.de	news
gastrojournal.org	scientific
mainelottery.com	usgov
worldpolicy.org	scientific
arstechnica.com	news
dawsoncreekdailynews.ca	news
bjd.com.cn	news
jaids.com	scientific
nvonews.com	news
amsus.org	scientific
governorbryant.com	usgov
jem.org	scientific
geek.com	news
amazon.com	commercial
dl.sciencesocieties.org	scientific
ecu.edu	scientific
pinterest.com	socialmedia
venturebeat.com	news
instagram.com	socialmedia|videos
nist.gov	usgov
cs.uwaterloo.ca	scientific
americanbar.org	scientific
qds.it	news
cancer.org	news
bjaesthetics.oxfordjournals.org	scientific
suedostschweiz.ch	news
howtogeek.com	news
serket2008.multiply.com	scientific
sensationalisttimes.com	fakenews
stb.dot.gov	usgov
perceptionweb.com	scientific
dgs.maryland.gov	usgov
jfe.sagepub.com	scientific
redjournal.org	scientific
soswy.state.wy.us	usgov
bizjournals.com	news
dts.edu	scientific
ndtourism.com	usgov
jbr.sagepub.com	scientific
seattletimes.com	news
electronicmarkets.org	scientific
cpr.sagepub.com	scientific
fcx.sagepub.com	scientific
astrogeo.oxfordjournals.org	scientific
fsb.oxfordjournals.org	scientific
ajpe.org	scientific
lematin.ch	news
fsigenetics.com	scientific
tdcj.state.tx.us	usgov
breitbart.com	fakenews
neoaristotelica.eu	scientific
aecsh.org	scientific
video.foxnews.com	news
gazzetta.it	news
warship.org	scientific
ati.es	scientific
british-dragonflies.org.uk	scientific
clickhole.com	fakenews
dn.se	news
annemergmed.com	scientific
reddit.com	socialmedia
akademikaforlag.no	scientific
bis.doc.gov	usgov
adn.com	news
cellbiolint.org	scientific
abonewscast.com	blog
flock.com	blog
entomologica.es	scientific
mns.org.my	scientific
nifc.gov	usgov
dcexaminer.com	news
nij.gov	usgov
jsr.sagepub.com	scientific
sibios.area.fi.cnr.it	scientific
jcp.aip.org	scientific
joe.endocrinology-journals.org	scientific
patriotpost.us	blog
sae.sagepub.com	scientific
va.gov	usgov
fasab.gov	usgov
tanea.gr	news
republicbroadcasting.org	blog
ldx.sagepub.com	scientific
liberta.it	news
dx.doi.org	scientific
nk.pl	socialmedia
truthkings.com	fakenews
csj.jp	scientific
s9y.org	blog
aspbs.com	scientific
ilkka.fi	news
ew.com	news
gosanangelo.com	news
emich.edu	scientific
jcs.mil	usgov
joh.sagepub.com	scientific
dclottery.com	usgov
presstv.ir	fakenews
ijts.tosok.or.kr	scientific
tyndale.cam.ac.uk	scientific
chcoc.gov	usgov
chunichi.co.jp	news
lequotidien.sn	news
ejinme.com	scientific
pediatricneurosciences.com	scientific
globes.co.il	news
insight-journal.org	scientific
msupress.msu.edu	scientific
funk.net	socialmedia|videos
divaina.com	news
sites.computer.org	scientific
ije.oxfordjournals.org	scientific
website.com	fakenews
iot.custhelp.com	usgov
math.vanderbilt.edu	scientific
virologyj.com	scientific
ismj.bpums.ac.ir	scientific
flalottery.com	usgov
trinj.com	scientific
japmaonline.org	scientific
wnd.com	fakenews
hawaii.edu	scientific
diariodeavila.es	news
indecisionforever.com	fakenews
studia-phaenomenologica.com	scientific
ieeecss.org	scientific
20minutes.fr	news
thedailystar.net	news
gecarbon.org	scientific
dhs.gov	usgov
rivista-statistica.unibo.it	scientific
mechademia.org	scientific
digitallibrary.amnh.org	scientific
libraweb.net	scientific
sac-oac.ca	scientific
a.msn.com	news
acta.inpa.gov.br	scientific
iowareview.uiowa.edu	scientific
miitomo.com	socialmedia
theintercept.com	news
niesr.ac.uk	scientific
mobile.reuters.com	news
jcem.endojournals.org	scientific
delottery.com	usgov
tnlottery.com	usgov
ita-savo.fi	news
dailytimes.com.pk	news
denaro.it	news
msa.press.jhu.edu	scientific
ijaweb.org	scientific
isc.kharkov.com	scientific
ndt.oxfordjournals.org	scientific
latribune-online.com	news
annales.miiz.waw.pl	scientific
usvidoj.codemeta.com	usgov
disa.mil	usgov
dukejournals.org	scientific
esapubs.org	scientific
pemberleybooks.com	scientific
aar.slu.edu	scientific
jccjournal.org	scientific
newrepublic.com	news
currentzoology.org	scientific
echo-doran.com	news
fuldaerzeitung.de	news
apy.sagepub.com	scientific
rinascita.eu	news
times-journal.com	news
latinamericanperspectives.com	scientific
fupress.com	scientific
cesa-tr.org	scientific
cesifo.oxfordjournals.org	scientific
doc.ks.gov	usgov
awdnews.com	fakenews
cae.cn	scientific
cjnr.sagepub.com	scientific
uottawa.scholarsportal.info	scientific
klemens.sav.sk	scientific
ottawasun.com	news
press.uchicago.edu	scientific
henrymakow.com	fakenews
clinical-genitourinary-cancer.com	scientific
coloradodaily.com	news
healthpolicyandtechnology.org	scientific
theunrealtimes.com	fakenews
artistprofile.com.au	scientific
tistory.com	blog
greenpharmacy.info	scientific
tigsource.com	news
faq.ssa.gov	usgov
ipeindia.org	scientific
westernfolklore.org	scientific
ios.doi.gov	usgov
erc.endocrinology-journals.org	scientific
rsc.org	scientific
isr.nus.edu.sg	scientific
humanevents.com	news
huffingtonpost.ca	news
raccefyn.co	scientific
conservativebyte.com	fakenews
jfdaily.com	news
jra.sagepub.com	scientific
ejkm.com	scientific
anesthesia-analgesia.org	scientific
mdm.sagepub.com	scientific
tafmed.org	scientific
secheresse.info	scientific
epilepsybehavior.com	scientific
whs.mil	usgov
emj.bmj.com	scientific
visitnj.org	usgov
ehjournal.net	scientific
depauw.edu	scientific
sobp.org	scientific
lin.sagepub.com	scientific
hr.pennpress.org	scientific
bnhs.org	scientific
ne.doe.gov	usgov
mabelsaveforschool.com	commercial
techradar.com	news
centrepresseaveyron.fr	news
ijce.iust.ac.ir	scientific
sefarad.revistas.csic.es	scientific
ft.com	news
bearingarms.com	blog
lobservateur.bf	news
thecps.org.uk	scientific
westernjournalism.com	fakenews
k-state.edu	scientific
lankadeepa.lk	news
sabrang.com	scientific
americanjournalofsurgery.com	scientific
centcom.mil	usgov
motherjones.com	fakenews
doc.state.co.us	usgov
techspot.com	news
bccb.lis.uiuc.edu	scientific
jbcs.sbq.org.br	scientific
ecis.ie	scientific
kommersant.ru	news
correct.state.ak.us	usgov
bmb.oxfordjournals.org	scientific
jpier.org	scientific
kiej.georgetown.edu	scientific
kluweronline.com	scientific
theblackscholar.org	scientific
sadaf.org.ar	scientific
tim.sagepub.com	scientific
jed.sagepub.com	scientific
kelownadailycourier.ca	news
revuecites.wordpress.com	scientific
cqx.sagepub.com	scientific
centralwesterndaily.com.au	news
tagblatt.ch	news
muse.jhu.edu	scientific
jivresearch.org	scientific
donotcall.gov	usgov
northcom.mil	usgov
usich.gov	usgov
oe24.at	news
lis.sagepub.com	scientific
ofr.gov	usgov
redflagnews.com	clickbait|fakenews
ubo.cl	scientific
maz-online.de	news
dailyrecordnews.com	news
conspiracywire.com	fakenews
theatlantic.com	news
journals.ametsoc.org	scientific
boingboing.net	blog
bmcinfectdis.biomedcentral.com	scientific
financialexpress.com	news
lux-post.lu	news
denverpost.com	news
thelancet.com	scientific
dia.mil	usgov
clinorthop.org	scientific
revistadyna.com	scientific
sett.com	blog
nejm.org	scientific
losgatosdailynews.com	news
thehopkinsreview.com	scientific
tourism.az.gov	usgov
lequotidien-oran.com	news
texasacademyofscience.org	scientific
e-ijd.org	scientific
biosignaling.com	scientific
ahde.urjc.es	scientific
heterocycles.jp	scientific
nature.com	news|scientific
parasitesandvectors.com	scientific
dotclear.org	blog
nhm.uio.no	scientific
vailmountaineer.com	news
lesdebats.com	news
rsh.sagepub.com	scientific
cmx.sagepub.com	scientific
ptep.oxfordjournals.org	scientific
prst-per.aps.org	scientific
phonebook.doe.gov	usgov
rh19.revues.org	scientific
bep.treas.gov	usgov
birds.cornell.edu	scientific
kainuunsanomat.fi	news
defenselink.mil	usgov
scienca-revuo.info	scientific
palges.de	scientific
atsjournals.org	scientific
politika.rs	news
racefromthefinish.com	commercial
jezebel.com	fakenews
dailybonnet.com	fakenews
ssees.ucl.ac.uk	scientific
bhutantimes.bt	news
backofthebook.ca	news
mail.nih.gov	usgov
newsbusters.org	fakenews
ccmjournal.com	scientific
aspj.co.za	scientific
bazmavep.com	scientific
mcv.revues.org	scientific
ww1.now-you-can-have.com	commercial
utulsa.edu	scientific
ltj.sagepub.com	scientific
midgard-project.org	blog
ba.no	news
akhbarelyoum-dz.com	news
tandf.co.uk	scientific
nhl.com	news
waterbirds.org	scientific
redstatewatcher.com	fakenews
asadl.org	scientific
tomccap.acm.org	scientific
nationalparks.org	usgov
psychgenetics.com	scientific
aaojournal.org	scientific
isw.sagepub.com	scientific
lacrossetribune.com	news
vef.gov	usgov
fandalism.com	socialmedia
imprint.co.uk	scientific
jeai.org	scientific
bas.sagepub.com	scientific
greenmountainsreview.com	scientific
veterinaryrecord.bvapublications.com	scientific
barometern.se	news
safnet.org	scientific
yurtgazetesi.com.tr	news
jos.sagepub.com	scientific
nugget.ca	news
groupelareference.afrikart.net	news
visitutah.com	usgov
socresonline.org.uk	scientific
journalofsurgicalresearch.com	scientific
onrr.gov	usgov
ejournal.unam.mx	scientific
intellihub.com	clickbait|fakenews
jmlr.org	scientific
schweizerbart.de	scientific
ijoc.org	scientific
locator.ice.gov	usgov
ar.rsmjournals.com	scientific
storiapatriasalerno.it	scientific
tn.gov	usgov
arbor.revistas.csic.es	scientific
hsx.sagepub.com	scientific
usadf.gov	usgov
mei.edu	scientific
v-r.de	scientific
medicaldaily.com	blog
qix.sagepub.com	scientific
themindunleashed.org	fakenews
iacr.org	scientific
persoonia.org	scientific
aprendeenlinea.udea.edu.co	scientific
elwatan.com	news
supremecourt.gov	usgov
thenewsnerd.com	fakenews
aop.sagepub.com	scientific
jhcm.sagepub.com	scientific
gastronomica.org	scientific
ejp.ejpecp.org	scientific
canadafreepress.com	fakenews
africaninvertebrates.org.za	scientific
ache.org	scientific
sljol.info	scientific
montgomeryadvertiser.com	news
prc.aps.org	scientific
rstl.royalsocietypublishing.org	scientific
scx.sagepub.com	scientific
libertyvideos.com	fakenews
4threvolutionarywar.wordpress.com	fakenews
aginganddisease.org	scientific
dhnet.be	news
pmj.sagepub.com	scientific
futuremedicine.com	scientific
hispanianova.rediris.es	scientific
jat.oxfordjournals.org	scientific
sagepub.com	news|scientific
aaacn.org	scientific
sobornost.org	scientific
jmews.org	scientific
security-and-peace.de	scientific
immunome-research.net	scientific
mashable.com	news
bgsu.edu	scientific
womenshealthandfitness.com.au	news
cis.ieee.org	scientific
app.sos.nh.gov	usgov
com.revues.org	scientific
shareasale.com	commercial
mid-day.com	news
thespoof.com	satire|fakenews
hljournals.org	scientific
jneuroinflammation.com	scientific
uex.sagepub.com	scientific
journals.aps.org	scientific
ledauphine.com	news
blackbird.vcu.edu	scientific
smp.se	news
nereview.com	scientific
fdic.gov	usgov
chron.com	news
estudiosamericanos.revistas.csic.es	scientific
dolomiten.it	news
iandc.csail.mit.edu	scientific
usbr.gov	usgov
genetics.org	scientific
edmontonsun.com	news
royensoc.co.uk	scientific
ilgiornale.it	news
access.wa.gov	usgov
jpsj.ipap.jp	scientific
fns.usda.gov	usgov
vjesnik.hr	news
visitmaryland.org	usgov
bioline.org.br	scientific
thegospelcoalition.org	scientific
sociologiedutravail.org	scientific
dossiersgrihl.revues.org	scientific
visitguam.com	usgov
unionesarda.it	news
endangered.fws.gov	usgov
elections.il.gov	usgov
redstates.com	fakenews
trialsjournal.com	scientific
callthecops.net	fakenews
mbajournal.kozminski.edu.pl	scientific
clinicaltrials.gov	usgov
compositio.nl	scientific
jmir.org	scientific
jungewelt.de	news
newscientist.com	news|scientific
sos.mt.gov	usgov
njelections.org	usgov
franceguyane.fr	news
vecer.mk	news
temoignages.re	news
singtao.com	news
tricare.mil	usgov
oldenbourg-verlag.de	scientific
wipfandstock.com	scientific
asclepio.revistas.csic.es	scientific
dallasnews.com	news
lottery.nd.gov	usgov
jcd.sagepub.com	scientific
thinakaran.lk	news
eeoc.gov	usgov
elections.delaware.gov	usgov
ves.sagepub.com	scientific
attajdid.ma	news
fieldmuseum.org	scientific
csce.gov	usgov
obamawhitehouse.archives.gov	news
abeldanger.net	fakenews
cit.uscourts.gov	usgov
nyrsf.com	scientific
me2day.net	socialmedia
spinejournal.com	scientific
israelhayom.co.il	news
ijnp.oxfordjournals.org	scientific
newswire-24.com	clickbait|fakenews
iel.vscht.cz	scientific
manoajournal.hawaii.edu	scientific
postimees.ee	news
aahhq.org	scientific
purchasing.utah.gov	usgov
chugoku-np.co.jp	news
rangifer.no	scientific
idahostatesman.com	news
lesoirdalgerie.com	news
forumdesas.cd	news
africanethnomedicines.net	scientific
thehindu.com	news
starnewsonline.com	news
sciencemag.org	news|scientific
capitol.gov	usgov
hetvolk.be	news
anp.sagepub.com	scientific
city.corriere.it	news
dcma.mil	usgov
wapa.gov	usgov
sudonline.sn	news
redeyechicago.com	news
globalpolicyjournal.com	scientific
radioelektronika.org	scientific
defense.gov	usgov
gao.gov	usgov
tods.acm.org	scientific
militianews.com	fakenews
museuprehistoriavalencia.es	scientific
revistas.usal.es	scientific
alrayalaam.com	news
dcclothesline.com	fakenews
healthcareitnews.com	news
theforbiddenknowledge.com	fakenews
governor.wv.gov	usgov
ilroma.net	news
indianjpsychiatry.org	scientific
medicinehatnews.com	news
ogs.ny.gov	usgov
jsm.sagepub.com	scientific
bloomberg.com	news
christiantimesnewspaper.com	fakenews
nationonenews.com	fakenews
consumerfinance.gov	usgov
bjui.org	scientific
cdp.sagepub.com	scientific
paa.sagepub.com	scientific
msha.gov	usgov
counterpunch.org	fakenews
journalnow.com	news
orthopaedicnursing.com	scientific
thenews.com.pk	news
whatdoesitmean.com	fakenews
tas.sagepub.com	scientific
ihavethetruth.com	fakenews
herder-institut.de	scientific
pressrepublican.com	news
gazette.com	news
eldercare.gov	usgov
liveleak.com	videos
portal.ehawaii.gov	usgov
lea.sagepub.com	scientific
jfr.geoscienceworld.org	scientific
mobile.nytimes.com	news
russia-direct.org	fakenews
springerlink.metapress.com	scientific
californiaagriculture.ucanr.org	scientific
nycgo.com	usgov
the-sun.on.cc	news
fi.mimuw.edu.pl	scientific
ajcn.org	scientific
lesauvage.org	news
square.umin.ac.jp	scientific
revue-egypte.org	scientific
scp.sagepub.com	scientific
doa.state.wi.us	usgov
centerforsecuritypolicy.org	fakenews
statcan.ca	scientific
realclearpolitics.com	blog
ajts.org	scientific
cellreports.cell.com	scientific
sciam.com	news
lobservateur.sn	news
pa.gov	usgov
gigasciencejournal.com	scientific
sponichi.co.jp	news
parool.nl	news
mend.endojournals.org	scientific
nola.com	news
talenthouse.com	blog
museumoftheearth.org	scientific
scriptorium.be	scientific
dailykos.com	news|fakenews
pluxml.org	blog
tjmc.edu.cn	scientific
sosym.org	scientific
genesdev.cshlp.org	scientific
apem-journal.org	scientific
mhd.sal.lv	scientific
aom.org	scientific
dissentmagazine.org	fakenews
governor.virginia.gov	usgov
techcrunch.com	news
jmt.dukejournals.org	scientific
pfr.sagepub.com	scientific
ane.pl	scientific
journals.impan.gov.pl	scientific
www-odi.nhtsa.dot.gov	usgov
hospitality.fiu.edu	scientific
social.wakoopa.com	socialmedia
rekihaku.ac.jp	scientific
kidb.org	scientific
omanobserver.om	news
reg.u-bordeaux3.fr	scientific
us.blastingnews.com	fakenews
asqde.org	scientific
bridge.lga1.admarketplace.net	commercial
gdp.ch	news
fenbilimleri.sdu.edu.tr	scientific
aas.org	scientific
gov.idaho.gov	usgov
uscfc.uscourts.gov	usgov
biometrics.tibs.org	scientific
uk.sagepub.com	scientific
ostp.gov	usgov
mathnet.ru	scientific
ruptly.tv	fakenews
mec.sagepub.com	scientific
od.nih.gov	usgov
roa.sagepub.com	scientific
ntis.gov	usgov
aiche.org	scientific
sdu.edu.tr	scientific
nof.econ.ku.dk	scientific
access-board.gov	usgov
visitflorida.com	usgov
aiqs.es	scientific
