URL	Categories	Sources
100percentfedup.com	fakenews	fakenewschecker|handcoded
199.44.84.82	usgov	usgov
1stcenturywire.com	fakenews	handcoded
209.235.208.145	scientific	wikidata
20min.ch	news	wikidata
20minutes.fr	news	wikidata
21stcenturywire.com	clickbait|fakenews	fakenewschecker|handcoded
24heures.ch	news	wikidata
24hrs.ca	news	wikidata
24sata.rs	news	wikidata
360.yahoo.com	blog	wikidata
365usanews.com	fakenews	fakenewschecker
4threvolutionarywar.wordpress.com	fakenews	fakenewschecker
660news.com	news	handcoded
70news.wordpress.com	fakenews	fakenewschecker
9gag.com	socialmedia	wikidata
a.msn.com	news	handcoded
a16z.com	blog	handcoded
aa.uwpress.org	scientific	wikidata
aaacn.org	scientific	wikidata
aaahq.org	scientific	wikidata
aaanet.org	scientific	wikidata
aaap.info	scientific	wikidata
aac.asm.org	scientific	wikidata
aacnclinicalissues.com	scientific	wikidata
aacp.com	scientific	wikidata
aaf.sagepub.com	scientific	wikidata
aafp.org	scientific	wikidata
aag.org	scientific	wikidata
aahhq.org	scientific	wikidata
aaiddjournals.org	scientific	handcoded
aan.sagepub.com	scientific	wikidata
aanda.org	scientific	wikidata
aaohnjournal.com	scientific	wikidata
aaojournal.org	scientific	wikidata
aapg.org	scientific	wikidata
aappublications.org	scientific	handcoded
aar.slu.edu	scientific	wikidata
aas.org	scientific	wikidata
aas.sagepub.com	scientific	wikidata
aasc.ucla.edu	scientific	wikidata
aasmnet.org	scientific	wikidata
aatsp.org	scientific	wikidata
aba.org	scientific	wikidata
abap.co.in	scientific	wikidata
abbs.oxfordjournals.org	scientific	wikidata
abc.es	news	wikidata
abcnews.com	news	handcoded
abcnews.com.co	fakenews	fakenewschecker|handcoded
abcnews.go.com	news	handcoded
abeldanger.net	fakenews	fakenewschecker
abendblatt.de	news	wikidata
abendzeitung.de	news	wikidata
abilityone.gov	usgov	usgov
abmc.gov	usgov	usgov
abonewscast.com	blog	handcoded
aboriginalhistory.org	scientific	wikidata
about.usps.com	usgov	usgov
abovetopsecret.com	fakenews	fakenewschecker
abpo.revues.org	scientific	wikidata
abqjournal.com	news	wikidata
abqtrib.com	news	wikidata
abs.sagepub.com	scientific	wikidata
ac.gobierno.pr	usgov	usgov
academia.edu	socialmedia	wikidata
academicjournals.org	scientific	wikidata
academicpedsjnl.net	scientific	wikidata
academie-sciences.fr	scientific	wikidata
academypublisher.com	scientific	wikidata
acadienouvelle.com	news	wikidata
acadsci.fi	scientific	wikidata
access-board.gov	usgov	usgov
access.wa.gov	usgov	usgov
accesshollywood.com	news	handcoded
ace-eco.org	scientific	wikidata
acf.hhs.gov	usgov	usgov
ach.sagepub.com	scientific	wikidata
ache.org	scientific	wikidata
achp.gov	usgov	usgov
acl.gov	usgov	usgov
acl.hhs.gov	usgov	usgov
acm.org	scientific	wikidata|handcoded
acns.org	scientific	wikidata
acorn.sbu.edu	scientific	wikidata
acps.org.au	scientific	wikidata
acsj.info	scientific	wikidata
acsm.revuesonline.com	scientific	wikidata
act.credoaction.com	commercial	handcoded
act.gov	usgov	usgov
act.org	usgov	usgov
acta-zoologica-bulgarica.eu	scientific	wikidata
acta.astrouw.edu.pl	scientific	wikidata
acta.chem-soc.si	scientific	wikidata
acta.inpa.gov.br	scientific	wikidata
acta.sapientia.ro	scientific	wikidata
actacardiologica.be	scientific	wikidata
actachemscand.dk	scientific	wikidata
actakoreana.kmu.ac.kr	scientific	wikidata
actamat.org	scientific	wikidata
actamathematica.org	scientific	wikidata
actamedicaportuguesa.com	scientific	wikidata
actaspsiquiatria.es	scientific	wikidata
actazool.nhmus.hu	scientific	wikidata
activistpost.com	clickbait|fakenews	fakenewschecker|handcoded
acu.edu	scientific	wikidata
acus.gov	usgov	usgov
ad.nl	news	wikidata
adc.arkansas.gov	usgov	usgov
adc.bmj.com	scientific	wikidata
addictinginfo.org	fakenews	fakenewschecker|handcoded
addictionjournal.org	scientific	wikidata
addiyar.com	news	wikidata
adeca.alabama.gov	usgov	usgov
adf.gov	usgov	usgov
adh.sagepub.com	scientific	wikidata
adisonline.com	scientific	wikidata
admin.ks.gov	usgov	usgov
admongo.gov	usgov	usgov
adn.com	news	wikidata
ador.alabama.gov	usgov	usgov
adr.gov	usgov	usgov
advmat.de	scientific	wikidata
advocate.com	fakenews	fakenewschecker
advopticalmat.de	scientific	wikidata
aeaweb.org	scientific	wikidata
aebioetica.org	scientific	wikidata
aece.ro	scientific	wikidata
aecsh.org	scientific	wikidata
aed.sagepub.com	scientific	wikidata
aef.izibookstore.com	scientific	wikidata
aei.sagepub.com	scientific	wikidata
aem.asm.org	scientific	wikidata
aemnp.eu	scientific	wikidata
aepp.oxfordjournals.org	scientific	wikidata
aeq.sagepub.com	scientific	wikidata
aequatoria.be	scientific	wikidata
aes.sagepub.com	scientific	wikidata
aesnet.org	scientific	wikidata
aespa.revistas.csic.es	scientific	wikidata
af.mil	usgov	usgov
aff.sagepub.com	scientific	wikidata
afonet.org	scientific	wikidata
afr.com	news	wikidata
afraf.oxfordjournals.org	scientific	wikidata
afrc.af.mil	usgov	usgov
afreserve.com	usgov	usgov
afrh.gov	usgov	usgov
africa-spectrum.org	scientific	wikidata
africa.ufl.edu	scientific	wikidata
africametro.com	fakenews	handcoded
africanbirdclub.org	scientific	wikidata
africaneconomicoutlook.org	scientific	wikidata
africanethnomedicines.net	scientific	wikidata
africaninvertebrates.org	scientific	wikidata
africaninvertebrates.org.za	scientific	wikidata
africapresse.com	news	wikidata
afrjpaedsurg.org	scientific	wikidata
afs.sagepub.com	scientific	wikidata
afsnet.org	scientific	wikidata
aftonbladet.se	news	wikidata
agalmaweb.org	scientific	wikidata
agefi.ch	news	wikidata
ageing.oxfordjournals.org	scientific	wikidata
ageofautism.com	fakenews	handcoded
agi.ac.za	scientific	wikidata
aginganddisease.org	scientific	wikidata
agriscientia.unc.edu.ar	scientific	wikidata
agu.org	scientific	wikidata
agupubs.onlinelibrary.wiley.com	scientific	wikidata
ahde.urjc.es	scientific	wikidata
ahistcon.org	scientific	wikidata
ahram.org.eg	news	wikidata
ahrq.gov	usgov	usgov
ahtribune.com	fakenews	fakenewschecker
ai.wyo.gov	usgov	usgov
aiche.org	scientific	wikidata
aidai.us	scientific	wikidata
aidc.org.za	fakenews	fakenewschecker
aidsonline.com	scientific	wikidata
aim.bmj.com	scientific	wikidata
aionlinguistica.com	scientific	wikidata
aip.de	scientific	wikidata
aipcnet.it	scientific	wikidata
aiqs.es	scientific	wikidata
airconsumer.ost.dot.gov	usgov	usgov
airforce.com	usgov	usgov
aisle.aisnet.org	scientific	wikidata
aja.asha.org	scientific	wikidata
aja.sagepub.com	scientific	wikidata
ajae.oxfordjournals.org	scientific	wikidata
ajc.com	news	wikidata
ajcn.org	scientific	wikidata
ajconline.org	scientific	wikidata
aje.oxfordjournals.org	scientific	wikidata
aje.sagepub.com	scientific	wikidata
ajevonline.org	scientific	wikidata
ajh.oxfordjournals.org	scientific	wikidata
ajh.sagepub.com	scientific	wikidata
ajhp.org	scientific	wikidata
ajhsjournal.or.ke	scientific	wikidata
ajkd.org	scientific	wikidata
ajl.sagepub.com	scientific	wikidata
ajm.sagepub.com	scientific	wikidata
ajns.paans.org	scientific	wikidata
ajo.com	scientific	wikidata
ajog.org	scientific	wikidata
ajol.info	scientific	wikidata
ajp.aapt.org	scientific	wikidata
ajp.amjpathol.org	scientific	wikidata
ajp.org	scientific	wikidata
ajp.psychiatryonline.org	scientific	wikidata
ajpcon.physiology.org	scientific	wikidata
ajpe.org	scientific	wikidata
ajph.org	scientific	wikidata
ajpmonline.org	scientific	wikidata
ajps.org	scientific	wikidata
ajs.or.at	scientific	wikidata
ajs.sagepub.com	scientific	wikidata
ajsonline.org	scientific	wikidata
ajtr.org	scientific	wikidata
ajts.org	scientific	wikidata
akademiai.com	scientific	wikidata
akademiaikiado.hu	scientific	wikidata
akademikaforlag.no	scientific	wikidata
akhbarelyoum-dz.com	news	wikidata
akismet.com	blog	wikidata
akkrt.hu	scientific	wikidata
al-fadjr.com	news	wikidata
al-qantara.revistas.csic.es	scientific	wikidata
al.com	news	wikidata
alabama.gov	usgov	usgov
alabama.travel	usgov	usgov
alabamainteractive.org	usgov	usgov
alabamavotes.gov	usgov	usgov
alaska.gov	usgov	usgov
alaskahighwaynews.ca	news	wikidata
albayane.press.ma	news	wikidata
alcatel-lucent.com	scientific	wikidata
alcesjournal.org	scientific	wikidata
alchourouk.com	news	wikidata
alger-republicain.com	news	wikidata
alh.sagepub.com	scientific	wikidata
allchemy.iq.usp.br	scientific	wikidata
allenwestrepublic.com	fakenews	handcoded
alliedacademies.org	scientific	wikidata
allnewspipeline.com	fakenews	fakenewschecker
almasryalyoum.com	news	wikidata
almassae.press.ma	news	wikidata
alpinejournal.org.uk	scientific	wikidata
alquds.com	news	wikidata
alrayalaam.com	news	wikidata
alsic.revues.org	scientific	wikidata
alternative-therapies.com	scientific	wikidata
alternative.ac.nz	scientific	wikidata
alternativemediasyndicate.com	fakenews	handcoded
alternet.org	fakenews	fakenewschecker
alumniportal-deutschland.org	socialmedia	wikidata
alzheimerjournal.com	scientific	wikidata
alzres.com	scientific	wikidata
ama.org	scientific	wikidata
amardeshonline.com	news	wikidata
amazon.com	commercial	handcoded
ambito.com	news	wikidata
amc.imfm.si	scientific	wikidata
amcs.uz.zgora.pl	scientific	wikidata
ameba.jp	socialmedia	wikidata
ameblo.jp	blog|socialmedia	wikidata
amergeog.org	scientific	wikidata
americablog.com	fakenews	fakenewschecker
american-music.org	scientific	wikidata
americanbar.org	scientific	wikidata
americanforensics.org	scientific	wikidata
americanfreepress.net	fakenews	fakenewschecker
americanjournalofsurgery.com	scientific	wikidata
americanlinguistics.org	scientific	wikidata
americanlookout .com	fakenews	fakenewschecker
americannews.com	fakenews	fakenewschecker|handcoded
americanoverlook.com	fakenews	fakenewschecker
americanpatriotdaily.com	fakenews	fakenewschecker
americanprogress.org	fakenews	fakenewschecker
americanquarterly.org	scientific	wikidata
americanreviewer.com	fakenews	fakenewschecker
americanriverreview.wordpress.com	scientific	wikidata
americansamoa.gov	usgov	usgov
americansamoa.travel	usgov	usgov
americansamoaelectionoffice.org	usgov	usgov
americanthinker.com	blog	handcoded
americaoggi.info	news	wikidata
americasfreedomfighters.com	fakenews	fakenewschecker
americorps.gov	usgov	usgov
amestribune.com	news	wikidata
ametsoc.org	scientific	wikidata
amici-thomae-mori.com	scientific	wikidata
amjbot.org	scientific	wikidata
amjmed.com	scientific	wikidata
amjmedsci.com	scientific	wikidata
amjtrans.com	scientific	wikidata
amm.shu.edu.cn	scientific	wikidata
ammin.geoscienceworld.org	scientific	wikidata
amny.com	news	wikidata
amp-nls.org	scientific	wikidata
amphilsoc.org	scientific	wikidata
amplifyingglass.com	satire|fakenews	handcoded
amren.com	fakenews	fakenewschecker
ams.allenpress.com	scientific	wikidata
ams.org	scientific	wikidata
ams.usda.gov	usgov	usgov
amsciepub.com	scientific	wikidata
amsocparasit.org	scientific	wikidata
amstat.org	scientific	wikidata
amstat.tandfonline.com	scientific	wikidata
amsus.org	scientific	wikidata
amta.no	news	wikidata
amtrak.com	usgov	usgov
amub.be	scientific	wikidata
an.no	news	wikidata
anakarder.com	scientific	wikidata
analescervantinos.revistas.csic.es	scientific	wikidata
analysis.oxfordjournals.org	scientific	wikidata
andeangeology.cl	scientific	wikidata
andjrnl.org	scientific	wikidata
andrewjohnpublishing.com	scientific	wikidata
andrews.edu	scientific	wikidata
ane.pl	scientific	wikidata
anesthesia-analgesia.org	scientific	wikidata
ang.sagepub.com	scientific	wikidata
angrypatriotmovement.com	fakenews	fakenewschecker
anilaggrawal.com	scientific	wikidata
animal-journal.eu	scientific	wikidata
anm.sagepub.com	scientific	wikidata
ann.sef.free.fr	scientific	wikidata
annaharonline.com	news	wikidata
annales.ehess.fr	scientific	wikidata
annales.miiz.waw.pl	scientific	wikidata
annali.unife.it	scientific	wikidata
annals.com	scientific	wikidata
annals.ensae.fr	scientific	wikidata
annals.in	scientific	wikidata
annals.org	scientific	wikidata
annalsafrmed.org	scientific	wikidata
annalsofepidemiology.org	scientific	wikidata
annalsofian.org	scientific	wikidata
annalsoftransplantation.com	scientific	wikidata
annalspc.com	scientific	wikidata
annclinlabsci.org	scientific	wikidata
anneeepigraphique.msh-paris.fr	scientific	wikidata
annemergmed.com	scientific	wikidata
annistonstar.com	news	wikidata
annonc.oxfordjournals.org	scientific	wikidata
annphys.org	scientific	wikidata
annsaudimed.net	scientific	wikidata
annualreviews.org	scientific	wikidata
anobii.com	socialmedia	wikidata
anonews.co	fakenews	fakenewschecker
anonnews.co	fakenews	handcoded
anotherdayintheempire.com	fakenews	fakenewschecker
anp.sagepub.com	scientific	wikidata
ansti.org	scientific	wikidata
answers.hrsa.gov	usgov	usgov
ant.sagepub.com	scientific	wikidata
antigonishreview.com	scientific	wikidata
antiquewireless.org	scientific	wikidata
antiwar.com	fakenews	fakenewschecker
anuariosatlanticos.casadecolon.com	scientific	wikidata
anzshm.org.au	scientific	wikidata
aoa.acl.gov	usgov	usgov
aoa.gov	usgov	usgov
aoac.org	scientific	wikidata
aob.oxfordjournals.org	scientific	wikidata
aobjournal.com	scientific	wikidata
aoc.gov	usgov	usgov
aol.com	commercial	handcoded
aom.org	scientific	wikidata
aop.sagepub.com	scientific	wikidata
aornjournal.org	scientific	wikidata
aota.org	scientific	wikidata
aott.org.tr	scientific	wikidata
aoucospubs.org	scientific	wikidata
ap.org	news|fakenews	handcoded
ap3.ee	news	wikidata
apa.org	scientific	wikidata
apalacheereview.org	scientific	wikidata
apem-journal.org	scientific	wikidata
aphapublications.org	scientific	handcoded
aphis.usda.gov	usgov	usgov
api.org.za	scientific	wikidata
app.pan.pl	scientific	wikidata
app.sos.nh.gov	usgov	usgov
apparatusjournal.net	scientific	wikidata
apple.com	commercial	handcoded
appleinsider.com	blog	handcoded
applij.oxfordjournals.org	scientific	wikidata
aprendeenlinea.udea.edu.co	scientific	wikidata
apsanet.org	scientific	wikidata
apsjournals.apsnet.org	scientific	wikidata
apuntesdepsicologia.es	scientific	wikidata
apy.sagepub.com	scientific	wikidata
aqua-aquapress.com	scientific	wikidata
ar.iiarjournals.org	scientific	wikidata
ar.rsmjournals.com	scientific	wikidata
ara.cat	news	wikidata
arabicedition.nature.com	scientific	wikidata
arabstudiesquarterly.plutojournals.org	scientific	wikidata
arages.de	scientific	wikidata
araldodellospettacolo.it	news	wikidata
arbeiterbewegung-jahrbuch.de	scientific	wikidata
arbor.revistas.csic.es	scientific	wikidata
arc.aiaa.org	scientific	wikidata
archeosciences.revues.org	scientific	wikidata
archim.org.uk	scientific	wikidata
archinte.ama-assn.org	scientific	wikidata
architalbiol.org	scientific	wikidata
architecture.yale.edu	scientific	wikidata
archives.gov	usgov	usgov
archivesofpathology.org	scientific	wikidata
archivoespañoldearte.revistas.csic.es	scientific	wikidata
archneur.jamanetwork.com	scientific	wikidata
archotol.ama-assn.org	scientific	wikidata
archpedi.ama-assn.org	scientific	wikidata
archpsyc.jamanetwork.com	scientific	wikidata
archsurg.jamanetwork.com	scientific	wikidata
arctic.gov	usgov	usgov
arctic.ucalgary.ca	scientific	wikidata
ard.bmj.com	scientific	wikidata
ardea.nou.nu	scientific	wikidata
ardeola.org	scientific	wikidata
arenadipola.it	news	wikidata
ariadne.ac.uk	scientific	wikidata
arj.sagepub.com	scientific	wikidata
arjournals.annualreviews.org	scientific	wikidata
arkansas.gov	usgov	usgov
arkansasonline.com	news	wikidata
arkat-usa.org	scientific	wikidata
armand-colin.com	scientific	wikidata
armfor.uscourts.gov	usgov	usgov
army.mil	usgov	usgov
aror.orient.cas.cz	scientific	wikidata
arp.sagepub.com	scientific	wikidata
arqarqt.revistas.csic.es	scientific	wikidata
ars.usda.gov	usgov	usgov
arsdisputandi.org	scientific	wikidata
arss.fr	scientific	wikidata
arstechnica.com	news	handcoded
arthritis-research.biomedcentral.com	scientific	wikidata
arthroscopyjournal.org	scientific	wikidata
articles.mercola.com	fakenews	handcoded
articulo.revues.org	scientific	wikidata
artistprofile.com.au	scientific	wikidata
arts.gov	usgov	usgov
arxiv.org	scientific	handcoded
asadl.org	scientific	wikidata
asahi.com	news	wikidata
asanet.org	scientific	wikidata
ascelibrary.org	scientific	wikidata
ascilite.org.au	scientific	wikidata
asclepio.revistas.csic.es	scientific	wikidata
ashjournal.com	scientific	wikidata
asianage.com	news	handcoded
asiapharmaceutics.info	scientific	wikidata
asih.org	scientific	wikidata
asj.or.jp	scientific	wikidata
asj.sagepub.com	scientific	wikidata
ask.fm	socialmedia	wikidata
aslonline.org	scientific	wikidata
asm.sagepub.com	scientific	wikidata
asma.org	scientific	wikidata
asmedl.aip.org	scientific	wikidata
asmedl.org	scientific	wikidata
asmjournals.org	scientific	wikidata
asor.org	scientific	wikidata
asp.eurasipjournals.com	scientific	wikidata
aspbs.com	scientific	wikidata
aspendailynews.com	news	wikidata
aspentimes.com	news	wikidata
aspj.co.za	scientific	wikidata
asport.fr	news	wikidata
aspt.net	scientific	wikidata
asq.sagepub.com	scientific	wikidata
asqde.org	scientific	wikidata
assafir.com	news	wikidata
assassinationscience.com	fakenews	fakenewschecker
associatedmediacoverage.com	fakenews	handcoded
astrogeo.oxfordjournals.org	scientific	wikidata
astronomisches-buero-wien.or.at	scientific	wikidata
astroreview.com	scientific	wikidata
astroscu.unam.mx	scientific	wikidata
asu.edu	scientific	wikidata
atf.gov	usgov	usgov
aththa.lk	news	wikidata
ati.es	scientific	wikidata
atmospheric-chemistry-and-physics.net	scientific	wikidata
atropos.info	scientific	wikidata
atsdr.cdc.gov	usgov	usgov
atsjournals.org	scientific	wikidata
attajdid.ma	news	wikidata
attn.com	fakenews	handcoded
atvb.ahajournals.org	scientific	wikidata
au.wiley.com	scientific	wikidata
audiology.org	scientific	wikidata
aufaitmaroc.com	news	wikidata
aujourdhui.ma	news	wikidata
auscps.com	scientific	wikidata
autismspeaks.org	scientific	handcoded
autoblog.com	blog	handcoded
autojusticeattorney.com	commercial	handcoded
automattic.com	blog	wikidata
avantionline.it	news	wikidata
avaz.ba	news	wikidata
avvenire.it	news	wikidata
awarenessact.com	fakenews	fakenewschecker
awazetribune.com	fakenews	fakenewschecker|handcoded
awdnews.com	fakenews	fakenewschecker
awt.cbp.gov	usgov	usgov
axs.com	commercial	handcoded
aynrandstudies.com	scientific	wikidata
az.com.na	news	wikidata
az.gov	usgov	usgov
azcentral.com	news	wikidata
azdailysun.com	news	wikidata
azdoa.gov	usgov	usgov
azdot.gov	usgov	usgov
azgovernor.gov	usgov	usgov
azsos.gov	usgov	usgov
azstarnet.com	news	wikidata
b2evolution.net	blog	wikidata
ba.no	news	wikidata
babylonbee.com	fakenews	handcoded
backofthebook.ca	news	handcoded
badisches-tagblatt.de	news	wikidata
baltimoreexaminer.com	news	wikidata
baltimorereview.org	scientific	wikidata
balzac-etudes.paris-sorbonne.fr	scientific	wikidata
bambooridge.com	scientific	wikidata
bangladeshtribune.com	news	wikidata
banglajol.info	scientific	wikidata
bap-journal.org	scientific	wikidata
barenakedislam.com	fakenews	fakenewschecker
barometern.se	news	wikidata
bas.sagepub.com	scientific	wikidata
baslerstab.ch	news	wikidata
battlecreekenquirer.com	news	wikidata
bayesian.org	scientific	wikidata
baywood.com	scientific	wikidata
baz.ch	news	wikidata
bazmavep.com	scientific	wikidata
bb.lv	news	wikidata
bb4sp.com	fakenews	fakenewschecker
bbc.co.uk	news	handcoded
bbc.com	news	handcoded
bbci.co.uk	news	handcoded
bbg.gov	usgov	usgov
bccb.lis.uiuc.edu	scientific	wikidata
bcjournal.org	scientific	wikidata
bclocalnews.com	news	wikidata
bcmj.org	scientific	wikidata
bcq.sagepub.com	scientific	wikidata
bcrme.press.illinois.edu	scientific	wikidata
bdj.pensoft.net	scientific	wikidata
bdlive.co.za	news	wikidata
bea.gov	usgov	usgov
bearbiology.com	scientific	wikidata
bearingarms.com	blog	handcoded
bebo.com	socialmedia	wikidata
beforeitsnews.com	clickbait|fakenews	fakenewschecker|handcoded
begellhouse.com	scientific	wikidata
behavioralandbrainfunctions.com	scientific	wikidata
beheco.oxfordjournals.org	scientific	wikidata
beilstein-journals.org	scientific	wikidata
beingliberal.org	fakenews	handcoded
bekhterev.ru	scientific	wikidata
bellpub.com	scientific	wikidata
beme.com	socialmedia|videos	wikidata
benjamins.com	scientific	wikidata
benning.army.mil	scientific	wikidata
bentham.org	scientific	wikidata
benthamscience.com	scientific	wikidata
bentspud.com	fakenews	fakenewschecker
bep.gov	usgov	usgov
bep.treas.gov	usgov	usgov
berghahnbooks.com	scientific	wikidata
berlindailysun.com	news	wikidata
berliner-kurier.de	news	wikidata
berliner-zeitung.de	news	wikidata
berlinertageszeitung.com	news	wikidata
berlingske.dk	news	wikidata
bernerzeitung.ch	news	wikidata
bet.com	news	handcoded
betakit.com	news	handcoded
betootaadvocate.com	fakenews	handcoded
bfictionreview.wordpress.com	scientific	wikidata
bgbm.org	scientific	wikidata
bgs.vermont.gov	usgov	usgov
bgsu.edu	scientific	wikidata
bhs.econ.census.gov	usgov	usgov
bhutantimes.bt	news	wikidata
bia.gov	usgov	usgov
bib.oxfordjournals.org	scientific	wikidata
bielertagblatt.ch	news	wikidata
bifea.revues.org	scientific	wikidata
bigadda.com	blog	handcoded
bigamericannews.com	fakenews	handcoded
bighairynews.com	fakenews	fakenewschecker
bignuggetnews.com	fakenews	fakenewschecker
bigpzone.com	clickbait|fakenews	handcoded
bigstory.ap.org	blog	handcoded
biij.org	scientific	wikidata
bild.de	news	wikidata
bio.kuleuven.be	scientific	wikidata
biochemj.org	scientific	wikidata
biochemsoctrans.org	scientific	wikidata
biodiversitylibrary.org	scientific	wikidata
bioessays-journal.com	scientific	wikidata
biohorizons.oxfordjournals.org	scientific	wikidata
bioinformatics.oxfordjournals.org	scientific	wikidata
bioingenioren.no	scientific	wikidata
biolbull.org	scientific	wikidata
biolcell.net	scientific	wikidata
bioline.org.br	scientific	wikidata
biology-direct.com	scientific	wikidata
biolreprod.org	scientific	wikidata
biolsci.org	scientific	wikidata
biomedcentral.com	scientific	wikidata|handcoded
biomedicaloptics.spiedigitallibrary.org	scientific	wikidata
biomedres.info	scientific	wikidata
biomet.oupjournals.org	scientific	wikidata
biometrics.tibs.org	scientific	wikidata
biometrische-gesellschaft.de	scientific	wikidata
bioone.org	scientific	wikidata
biosignaling.com	scientific	wikidata
biosoc.pk	scientific	wikidata
biostatistics.oxfordjournals.org	scientific	wikidata
biotechniques.com	scientific	wikidata
bipartisanreport.com	fakenews	fakenewschecker|handcoded
bips.ac.uk	scientific	wikidata
birdlife.fi	scientific	wikidata
birds.cornell.edu	scientific	wikidata
birdssa.asn.au	scientific	wikidata
bis.doc.gov	usgov	usgov
bise-journal.org	scientific	wikidata
bizjournals.com	news	handcoded
bizpacreview.com	fakenews	fakenewschecker|handcoded
biztek.edu.pk	scientific	wikidata
bja.oxfordjournals.org	scientific	wikidata
bjaesthetics.oxfordjournals.org	scientific	wikidata
bjbms.org	scientific	wikidata
bjc.oxfordjournals.org	scientific	wikidata
bjcancer.com	scientific	wikidata
bjcn.co.uk	scientific	wikidata
bjcp-journal.com	scientific	wikidata
bjd.com.cn	news	wikidata
bjgp.org	scientific	wikidata
bji.sagepub.com	scientific	wikidata
bjj.boneandjoint.org.uk	scientific	wikidata
bjmp.org	scientific	wikidata
bjo.bmj.com	scientific	wikidata
bjp.rcpsych.org	scientific	wikidata
bjr.sagepub.com	scientific	wikidata
bjs.co.uk	scientific	wikidata
bjs.ojp.usdoj.gov	usgov	usgov
bjsm.co.uk	scientific	wikidata
bjui.org	scientific	wikidata
blackbird.vcu.edu	scientific	wikidata
blackclock.org	scientific	wikidata
blackgenocide.org	fakenews	fakenewschecker
blacklistednews.com	fakenews	fakenewschecker
blackwell-compass.com	scientific	wikidata
blackwell-synergy.com	scientific	wikidata
blackwellpublishing.com	scientific	wikidata
blacpma.usach.cl	scientific	wikidata
blasting.news	fakenews	handcoded
blesk.cz	news	wikidata
blick.ch	news	wikidata
blm.gov	usgov	usgov
blog.co.uk	blog	handcoded
blog.com	blog	handcoded
blog.de	blog	handcoded
blog.hr	blog	handcoded
blog.smw.ch	scientific	wikidata
blogdrive.com	blog	handcoded
blogger.com	blog|socialmedia	wikidata|handcoded
blogher.com	blog	handcoded
blogsome.com	blog	handcoded
blogspot.com	blog	handcoded
blogtalkradio.com	news	handcoded
bloodjournal.org	scientific	wikidata
bloodtransfusion.it	scientific	wikidata
bloomberg.com	news	handcoded
blosxom.sf.net	blog	wikidata
bls.gov	usgov|scientific	usgov|wikidata
bluenationreview.com	fakenews	fakenewschecker|handcoded
blueridgenow.com	news	wikidata
bmb.oxfordjournals.org	scientific	wikidata
bmcgenomics.biomedcentral.com	scientific	wikidata
bmcinfectdis.biomedcentral.com	scientific	wikidata
bmcmicrobiol.biomedcentral.com	scientific	wikidata
bmcneurol.biomedcentral.com	scientific	wikidata
bmcpediatr.biomedcentral.com	scientific	wikidata
bmcpublichealth.biomedcentral.com	scientific	wikidata
bmcurol.biomedcentral.com	scientific	wikidata
bmj.com	scientific	wikidata|handcoded
bmjopen.bmj.com	scientific	wikidata
bmo.sagepub.com	scientific	wikidata
bms.ulb.ac.be	scientific	wikidata
bmv.ohio.gov	usgov	usgov
bnhs.org	scientific	wikidata
bnn.de	news	wikidata
boa.sd.gov	usgov	usgov
boem.gov	usgov	usgov
bohuslaningen.se	news	wikidata
boingboing.net	blog	handcoded
bolivianchemistryjournal.org	scientific	wikidata
bonewitz.de	scientific	wikidata
bookmooch.com	socialmedia	wikidata
booksandjournals.brillonline.com	scientific	wikidata
bookstore.gpo.gov	usgov	usgov
bop.gov	usgov	usgov
bordeaux7.com	news	wikidata
borowitzreport.com	fakenews	fakenewschecker|handcoded
bos.org.uk	scientific	wikidata
bostonglobe.com	news	wikidata
botanica.org.br	scientific	wikidata
botges.ch	scientific	wikidata
boulevardmagazine.org	scientific	wikidata
bpa.gov	usgov	usgov
bpb.pharm.or.jp	scientific	wikidata
brain.oxfordjournals.org	scientific	wikidata
brandonsun.com	news	wikidata|handcoded
brantfordexpositor.ca	news	wikidata
bravenet.com	blog	handcoded
breakingnews.com	news	handcoded
breitbart.com	fakenews	fakenewschecker|handcoded
briarcliff.edu	scientific	wikidata
bridge.lga1.admarketplace.net	commercial	handcoded
brill.com	scientific	wikidata
brill.nl	scientific	wikidata
britac.ac.uk	scientific	wikidata
britastro.org	scientific	wikidata
british-dragonflies.org.uk	scientific	wikidata
brjpharmacol.org	scientific	wikidata
brn.sagepub.com	scientific	wikidata
brookings.edu	scientific	wikidata
bsas.org.uk	scientific	wikidata
bsee.gov	usgov	usgov
bst.sagepub.com	scientific	wikidata
bsu.edu	scientific	wikidata
bsw.org	scientific	wikidata
bt.dk	news	wikidata
bt.no	news	wikidata
bto.org	scientific	wikidata
bts.gov	usgov	usgov
bu.edu	scientific	wikidata
buddypress.org	blog	wikidata
buenosairesherald.com	news	wikidata
buffalonews.com	news	wikidata
bukedde.co.ug	news	wikidata
bul.sagepub.com	scientific	wikidata
bulletindepsychologie.net	scientific	wikidata
bulletinofinsectology.org	scientific	wikidata
burlingtonfreepress.com	news	wikidata
burrardstreetjournal.com	fakenews	handcoded
business-standard.com	news	handcoded
businessdayonline.com	news	wikidata
businessinsider.com	news	handcoded
businessweek.com	news	handcoded
buzzfeed.com	news	handcoded
bwr.ua.edu	scientific	wikidata
bz-berlin.de	news	wikidata
c-span.org	news	handcoded
ca.gov	usgov	usgov
caans-acaen.ca	scientific	wikidata
cacm.acm.org	scientific	wikidata
cactusexplorers.org.uk	scientific	wikidata
cad.sagepub.com	scientific	wikidata
cadillacnews.com	news	wikidata
cae.cn	scientific	wikidata
cafc.uscourts.gov	usgov	usgov
cahiersagricultures.fr	scientific	wikidata
cairn.info	scientific	wikidata
cairns.com.au	news	wikidata
calbotsoc.org	scientific	wikidata
calgaryherald.com	news	wikidata
calgarysun.com	news	wikidata|handcoded
californiaagriculture.ucanr.org	scientific	wikidata
californiatourism.ca.gov	usgov	usgov
callaloo.tamu.edu	scientific	wikidata
caller.com	news	wikidata
callthecops.net	fakenews	fakenewschecker
calottery.com	usgov	usgov
calyxpress.org	scientific	wikidata
cambridge.org	scientific	wikidata
camden.rutgers.edu	scientific	wikidata
cameraobscura.dukejournals.org	scientific	wikidata
cameroon-tribune.cm	news	wikidata
campaignsandelections.com	scientific	wikidata
canada.com	news	wikidata|handcoded
canadafreepress.com	fakenews	fakenewschecker
canadianbusiness.com	news	handcoded
canadiandimension.com	fakenews	fakenewschecker
cancer.org	news	handcoded
cancercell.org	scientific	wikidata
cancerepidemiology.net	scientific	wikidata
cancerjournal.net	scientific	wikidata
cancerres.aacrjournals.org	scientific	wikidata
canoe.ca	news	handcoded
canoe.com	news	handcoded
canonlaw.cua.edu	scientific	wikidata
canteenmag.com	scientific	wikidata
cao.gov	usgov	usgov
cap-news.com	fakenews	fakenewschecker|handcoded
capebretonpost.com	news	wikidata
capitol.gov	usgov	usgov
capnews.com	fakenews	handcoded
cappsy.org	scientific	wikidata
car.sagepub.com	scientific	wikidata
caravanmagazine.in	news	handcoded
carcin.oxfordjournals.org	scientific	wikidata
carcinogenesis.com	scientific	wikidata
cardiab.com	scientific	wikidata
cardiac-nursing.co.uk	scientific	wikidata
care.diabetesjournals.org	scientific	wikidata
carleton.ca	scientific	wikidata
carlisle.army.mil	scientific	wikidata
carnegiemnh.org	scientific	wikidata
carnivorousplants.org	scientific	wikidata
casesjournal.com	scientific	wikidata
castaneajournal.org	scientific	wikidata
cat.sagepub.com	scientific	wikidata
catalog.gpo.gov	usgov	usgov
catalogingandclassificationquarterly.com	scientific	wikidata
catalogue.nla.gov.au	scientific	wikidata
cato.org	scientific	wikidata
cbc.ca	news	handcoded
cbj.ca	news	handcoded
cbo.gov	usgov	usgov
cbp.gov	usgov	usgov
cbr.sagepub.com	scientific	wikidata
cbsnews.com	news	handcoded
cbssports.com	news	handcoded
cc.com	fakenews	handcoded
ccforum.com	scientific	wikidata
ccj.sagepub.com	scientific	wikidata
ccl.sagepub.com	scientific	wikidata
ccm.geoscienceworld.org	scientific	wikidata
ccmjournal.com	scientific	wikidata
ccms.ukzn.ac.za	scientific	wikidata
ccp.sagepub.com	scientific	wikidata
ccs.sagepub.com	scientific	wikidata
ccsu.edu	scientific	wikidata
cd.nm.gov	usgov	usgov
cdc.gov	usgov|scientific	usgov|wikidata
cdcr.ca.gov	usgov	usgov
cde.sagepub.com	scientific	wikidata
cdp.sagepub.com	scientific	wikidata
cdq.sagepub.com	scientific	wikidata
cdt.ch	news	wikidata
ceaccp.oxfordjournals.org	scientific	wikidata
cebp.aacrjournals.org	scientific	wikidata
cefi.ca	news	handcoded
cejiss.org	scientific	wikidata
cell-research.com	scientific	wikidata
cell.com	scientific	wikidata
cellbiolint.org	scientific	wikidata
cellhostandmicrobe.com	scientific	wikidata
cellmetabolism.org	scientific	wikidata
cellreports.cell.com	scientific	wikidata
cem.va.gov	usgov	usgov
cema.edu.ar	scientific	wikidata
census.gov	usgov	usgov
centcom.mil	usgov	usgov
centerforsecuritypolicy.org	fakenews	fakenewschecker
centralwesterndaily.com.au	news	wikidata
centrepresseaveyron.fr	news	wikidata
cepc.gob.es	scientific	wikidata
cercec.fr	scientific	wikidata
cercor.oxfordjournals.org	scientific	wikidata
cesa-tr.org	scientific	wikidata
cesifo.oxfordjournals.org	scientific	wikidata
ceylontoday.lk	news	wikidata
cfa.gov	usgov	usgov
cffc.navy.mil	usgov	usgov
cfo.gov	usgov	usgov
cfp.ca	scientific	wikidata
cfpb.gov	usgov	usgov
cftc.gov	usgov	usgov
cghjournal.org	scientific	wikidata
ch.revues.org	scientific	wikidata
chance.amstat.org	scientific	wikidata
change.org	commercial	handcoded
channel-7-news.com	fakenews	fakenewschecker
charentelibre.com	news	wikidata
charlestonco.com	scientific	wikidata
chartattack.com	news	handcoded
chas-daily.com	news	wikidata
chaser.com.au	fakenews	handcoded
chbeck.de	scientific	wikidata
chcoc.gov	usgov	usgov
chd.sagepub.com	scientific	wikidata
cheapassgamer.com	news	handcoded
chelonian.org	scientific	wikidata
chem.uw.edu.pl	scientific	wikidata
chemanager.com	scientific	wikidata
chembiochem.org	scientific	wikidata
chemeducator.org	scientific	wikidata
chemistry.or.jp	scientific	wikidata
chennaimath.org	scientific	wikidata
chestjournal.org	scientific	wikidata
chi.sagepub.com	scientific	wikidata
chicagoreview.org	scientific	wikidata
chicagotribune.com	news	wikidata|handcoded
childwelfare.gov	usgov	usgov
chimia.ch	scientific	wikidata
chiroandosteo.com	scientific	wikidata
chjs.soche.cl	scientific	wikidata
chp.sagepub.com	scientific	wikidata
chretienssocietes.revues.org	scientific	wikidata
christiantimesnewspaper.com	fakenews	fakenewschecker
christwire.org	fakenews	fakenewschecker|handcoded
chron.com	news	wikidata|handcoded
chronicle.gi	news	wikidata
chronicle.su	clickbait|fakenews	fakenewschecker|handcoded
chroniclejournal.com	news	wikidata
chs.revues.org	scientific	wikidata
chugoku-np.co.jp	news	wikidata
chungara.cl	scientific	wikidata
chunichi.co.jp	news	wikidata
chyrp.net	blog	wikidata
ci.nii.ac.jp	scientific	wikidata
cia.gov	usgov|scientific	usgov|wikidata
cialc.unam.mx	scientific	wikidata
cie.acm.org	scientific	wikidata
cief.info	scientific	wikidata
ciencias.bogota.unal.edu.co	scientific	wikidata
cigie.gov	usgov	usgov
cigjournals.com	scientific	wikidata
cimarronreview.okstate.edu	scientific	wikidata
cin.sagepub.com	scientific	wikidata
cincinnati.com	news	wikidata
cio.gov	usgov	usgov
circ.ahajournals.org	scientific	wikidata
circleofdocs.com	blog	handcoded
circres.ahajournals.org	scientific	wikidata
circumpolarhealthjournal.net	scientific	wikidata
cis-sic.ca	news	handcoded
cis.ieee.org	scientific	wikidata
cit.uscourts.gov	usgov	usgov
city-analysis.net	scientific	wikidata
city.corriere.it	news	wikidata
cityam.com	news	wikidata
civictribune.com	fakenews	fakenewschecker|handcoded
civilisations.revues.org	scientific	wikidata
cjasn.asnjournals.org	scientific	wikidata
cjb.sagepub.com	scientific	wikidata
cjc.wiley-vch.de	scientific	wikidata
cjche.com.cn	scientific	wikidata
cje.oxfordjournals.org	scientific	wikidata
cjnr.sagepub.com	scientific	wikidata
cjr.org	scientific	handcoded
cla.purdue.edu	scientific	wikidata
cla.sagepub.com	scientific	wikidata
clarin.com	news	wikidata
clarku.edu	scientific	wikidata
clashdaily.com	fakenews	fakenewschecker
clemson.edu	scientific	wikidata
clerk.house.gov	usgov	usgov
clicanoo.re	news	wikidata
clickhole.com	fakenews	fakenewschecker|handcoded
clincancerres.aacrjournals.org	scientific	wikidata
clinical-breast-cancer.com	scientific	wikidata
clinical-colorectal-cancer.com	scientific	wikidata
clinical-genitourinary-cancer.com	scientific	wikidata
clinical-laboratory.de	scientific	wikidata
clinical-lung-cancer.com	scientific	wikidata
clinicalmicrobiologyandinfection.com	scientific	wikidata
clinicalpain.com	scientific	wikidata
clinicaltherapeutics.com	scientific	wikidata
clinicaltrials.gov	usgov	usgov
clinorthop.org	scientific	wikidata
clinsci.org	scientific	wikidata
cloud-cuckoo.net	scientific	wikidata
clt.sagepub.com	scientific	wikidata
clta-us.org	scientific	wikidata
club.japantimes.co.jp	news	wikidata
cma.ca	scientific	wikidata
cmaj.ca	scientific	wikidata|handcoded
cmb.ac.lk	scientific	wikidata
cmj.org	scientific	wikidata
cmos.ca	scientific	wikidata
cmr.berkeley.edu	scientific	wikidata
cms.gov	usgov	usgov
cms.hhs.gov	usgov	usgov
cms.math.ca	scientific	wikidata
cms.skidmore.edu	scientific	wikidata
cmstudies.org	scientific	wikidata
cmx.sagepub.com	scientific	wikidata
cnbc.com	news	handcoded
cnc.sagepub.com	scientific	wikidata
cnet.com	news	handcoded
cnic.navy.mil	usgov	usgov
cnn.com	news	handcoded
cnr.sagepub.com	scientific	wikidata
cns.gov	usgov	usgov
cnsfederation.org	scientific	wikidata
cnsnews.com	blog	handcoded
cnsspectrums.com	scientific	wikidata
coasttocoastam.com	clickbait|fakenews	fakenewschecker|handcoded
cochrane.org	scientific	handcoded
cochranelibrary.com	scientific	handcoded
codesria.org	scientific	wikidata
coffeemeetsbagel.com	socialmedia	wikidata
cogconnected.com	news	handcoded
coleopterist.org.uk	scientific	wikidata
collective-evolution.com	fakenews	fakenewschecker|handcoded
collectivelyconscious.net	fakenews	fakenewschecker
collegian.psu.edu	news	wikidata
colombiamedica.univalle.edu.co	scientific	wikidata
colorado.com	usgov	usgov
colorado.edu	scientific	wikidata
colorado.gov	usgov	usgov
coloradodaily.com	news	wikidata
coloradoreview.colostate.edu	scientific	wikidata
colpos.mx	scientific	wikidata
columbiadailyherald.com	news	wikidata
columbiajournal.org	scientific	wikidata
com.de	fakenews	handcoded
com.revues.org	scientific	wikidata
combinatorics.org	scientific	wikidata
comjnl.oxfordjournals.org	scientific	wikidata
comm.utoronto.ca	scientific	wikidata
commerce.gov	usgov	usgov
commercialappeal.com	news	wikidata
commercialbiotechnology.com	scientific	wikidata
commissaries.com	usgov	usgov
commondreams.org	fakenews	fakenewschecker
commonknowledge.dukejournals.org	scientific	wikidata
commons.pacificu.edu	scientific	wikidata
communio-icr.com	scientific	wikidata
compcytogen.pensoft.net	scientific	wikidata
complementarytherapiesinmedicine.com	scientific	wikidata
complex-systems.com	scientific	wikidata
complex.com	scientific	wikidata
compliance.gov	usgov	usgov
compositio.nl	scientific	wikidata
comprehensivephysiology.com	scientific	wikidata
computer.org	scientific	wikidata|handcoded
computermusicjournal.org	scientific	wikidata
computerweekly.com	news	handcoded
computingreviews.com	scientific	wikidata
comsoc.org	scientific	wikidata
con.sagepub.com	scientific	wikidata
conbio.org	scientific	wikidata
conchasbrasil.org.br	scientific	wikidata
conchsoc.org	scientific	wikidata
concrete5.org	blog	wikidata
conferencecalltranscripts.org	commercial	handcoded
confluence.ou.edu	scientific	wikidata
confluenze.unibo.it	scientific	wikidata
confrontationmagazine.org	scientific	wikidata
conjunctions.com	scientific	wikidata
connect.ga.gov	usgov	usgov
connections-qj.org	scientific	wikidata
connectjournals.com	scientific	wikidata
consciouslifenews.com	clickbait|fakenews	fakenewschecker|handcoded
conservation-science.unibo.it	scientific	wikidata
conservationandsociety.org	scientific	wikidata
conservativebyte.com	fakenews	fakenewschecker
conservativedailypost.com	fakenews	fakenewschecker
conservativefiringline.com	fakenews	fakenewschecker
conservativefrontline.com	fakenews	fakenewschecker
conservativeinfidel.com	fakenews	fakenewschecker
conservativeoutfitters.com	clickbait|fakenews	fakenewschecker|handcoded
conservativepapers.com	fakenews	fakenewschecker
conservativerefocus.com	fakenews	fakenewschecker
conservativestate.com	fakenews	fakenewschecker
conservativetribune.com	fakenews	fakenewschecker
conspiracyplanet.com	fakenews	fakenewschecker
conspiracywire.com	fakenews	handcoded
constellationsjournal.org	scientific	wikidata
constitution.com	blog	handcoded
constitutioncenter.org	usgov	usgov
consumer.discoverohio.com	usgov	usgov
consumer.ftc.gov	usgov	usgov
consumerfinance.gov	usgov	usgov
contact-us.state.gov	usgov	usgov
contact.darpa.mil	usgov	usgov
content.iospress.com	scientific	wikidata
content.karger.com	scientific	wikidata
content.onlinejacc.org	scientific	wikidata
content.sabinet.co.za	scientific	wikidata
contexts.org	scientific	wikidata
conwaydailysun.com	news	wikidata
copainsdavant.com	socialmedia	wikidata
cops.usdoj.gov	usgov	usgov
copyright.gov	usgov	usgov
cor.mt.gov	usgov	usgov
cor.pa.gov	usgov	usgov
corbettreport.com	fakenews	fakenewschecker
cornellhrreview.org	scientific	wikidata
cornelljournalofarchitecture.cornell.edu	scientific	wikidata
corpweb1.dfas.mil	usgov	usgov
correct.state.ak.us	usgov	usgov
corrections.az.gov	usgov	usgov
corrections.ky.gov	usgov	usgov
corrections.nebraska.gov	usgov	usgov
corrections.utah.gov	usgov	usgov
corrections.wy.gov	usgov	usgov
corriere.com	news	wikidata
corriere.it	news	wikidata
corrieredelmezzogiorno.corriere.it	news	wikidata
corrieredelveneto.corriere.it	news	wikidata
corrieredicomo.it	news	wikidata
corrieredilivorno.com	news	wikidata
corrieredisiena.it	news	wikidata
corrieremercantile.it	news	wikidata
corrierenazionale.it	news	wikidata
corriereromagna.it	news	wikidata
corsematin.com	news	wikidata
cos.sagepub.com	scientific	wikidata
cosmo-mg.mcgill.ca	scientific	wikidata
countdowntozerotime.com	clickbait|fakenews	fakenewschecker|handcoded
countercurrentnews.com	fakenews	fakenewschecker
counterjihadreport.com	blog	handcoded
counterpsyops.com	clickbait|fakenews	fakenewschecker|handcoded
counterpunch.org	fakenews	fakenewschecker
courant.com	news	wikidata
courierpress.com	news	wikidata
cowgernation.com	fakenews	fakenewschecker
cpa.ca	scientific	wikidata
cpa.sagepub.com	scientific	wikidata
cpcjournal.org	scientific	wikidata
cpjournal.ca	scientific	wikidata
cpl.iphy.ac.cn	scientific	wikidata
cpmt.org	scientific	wikidata
cpr.sagepub.com	scientific	wikidata
cpsa-acsp.ca	scientific	wikidata
cpsc.gov	usgov|news	usgov|handcoded
cpt.sagepub.com	scientific	wikidata
cqx.sagepub.com	scientific	wikidata
cracked.com	fakenews	fakenewschecker|handcoded
crazyhorse.cofc.edu	scientific	wikidata
crd.sagepub.com	scientific	wikidata
creambmp.com	fakenews	fakenewschecker|handcoded
credoaction.com	commercial	handcoded
cri.sagepub.com	scientific	wikidata
cria.polis.cam.ac.uk	scientific	wikidata
critica.filosoficas.unam.mx	scientific	wikidata
criticalcare.theclinics.com	scientific	wikidata
criticalinquiry.uchicago.edu	scientific	wikidata
criticalreview.com	scientific	wikidata
critiquejournal.net	scientific	wikidata
crj.sagepub.com	scientific	wikidata
crl.acrl.org	scientific	wikidata
crln.acrl.org	scientific	wikidata
cronachedalmondo.com	news	wikidata
cronicadeportiva.com	fakenews	fakenewschecker
crooksandliars.com	fakenews	fakenewschecker
crops.org	scientific	wikidata
crossings.tcd.ie	scientific	wikidata
crs.sagepub.com	scientific	wikidata
crw.sagepub.com	scientific	wikidata
crx.sagepub.com	scientific	wikidata
cs.ucsb.edu	scientific	wikidata
cs.uwaterloo.ca	scientific	wikidata
csb.gov	usgov	usgov
csc.kth.se	scientific	wikidata
csce.gov	usgov	usgov
csci.agh.edu.pl	scientific	wikidata
csfs.ca	scientific	wikidata
csj.jp	scientific	wikidata
csmonitor.com	news	handcoded
csosa.gov	usgov	usgov
csrees.usda.gov	usgov	usgov
csx.sagepub.com	scientific	wikidata
ct.gov	usgov	usgov
ctj.sagepub.com	scientific	wikidata
ctlottery.org	usgov	usgov
ctoz.nl	scientific	wikidata
ctr.sagepub.com	scientific	wikidata
cts.access-board.gov	usgov	usgov
ctvisit.com	usgov	usgov
ctvnews.ca	news	handcoded
cuadernos.info	scientific	wikidata
cuadernosdebiodiversidad.org	scientific	wikidata
cullmantimes.com	news	wikidata
cumhuriyet.com	news	wikidata
cuonline.ncua.gov	usgov	usgov
current-biology.com	scientific	wikidata
currents.plos.org	scientific	wikidata
currentscience.ac.in	scientific	wikidata
currentzoology.org	scientific	wikidata
cutbankonline.org	scientific	wikidata
cvawards.ca	news	handcoded
cvc.cervantes.es	scientific	wikidata
cvd-journal.de	scientific	wikidata
cvi.asm.org	scientific	wikidata
cvironline.org	scientific	wikidata
cw.psypress.com	scientific	wikidata
cwins.wpi.edu	scientific	wikidata
cww.oxfordjournals.org	scientific	wikidata
cyberdriveillinois.com	usgov	usgov
cyberpresse.ca	news	wikidata
cyprus-mail.com	news	wikidata
cysjournal.ca	scientific	wikidata
cyworld.com	socialmedia	wikidata
dad.boun.edu.tr	scientific	wikidata
dag.revista.uab.es	scientific	wikidata
dagbladet.se	news	wikidata
dagsavisen.no	news	wikidata
daily.co.jp	news	wikidata
dailybonnet.com	fakenews	handcoded
dailybreeze.com	news	wikidata
dailybulletin.ca	news	wikidata
dailybuzzlive.com	clickbait|fakenews	fakenewschecker|handcoded
dailycaller.com	news|fakenews	fakenewschecker|handcoded
dailycamera.com	news	wikidata
dailycollegian.com	news	wikidata
dailycomet.com	news	wikidata
dailycurrant.com	fakenews	fakenewschecker|handcoded
dailydiscord.com	fakenews	fakenewschecker
dailydot.com	blog	handcoded
dailygamecock.com	news	wikidata
dailygleaner.canadaeast.com	news	wikidata
dailyheadlines.net	fakenews	fakenewschecker
dailyheraldtribune.com	news	wikidata
dailyhome.com	news	wikidata
dailykos.com	news|fakenews	fakenewschecker|handcoded
dailymail.co.uk	news	wikidata|handcoded
dailymirror.lk	news	wikidata
dailymotion.com	videos	wikidata
dailynews.co.tz	news	wikidata
dailynews.co.zw	news	wikidata
dailynews.com	news	wikidata
dailynews.lk	news	wikidata
dailynewsbin.com	fakenews	fakenewschecker
dailyoccupation.com	fakenews	fakenewschecker
dailyprogress.com	news	wikidata
dailyrecord.co.uk	news	wikidata
dailyrecordnews.com	news	wikidata
dailysignal.com	news	handcoded
dailysquib.co.uk	fakenews	fakenewschecker|handcoded
dailystar.co.uk	news	wikidata
dailystormer.com	fakenews	fakenewschecker
dailytech.com	news	handcoded
dailytelegraph.news.com.au	news	wikidata
dailytimes.com.pk	news	wikidata
dailytownsman.com	news	wikidata
dailywire.com	fakenews	handcoded
dainikbhaskargroup.com	news	wikidata
dallasnews.com	news	wikidata
dallasvoice.com	fakenews	fakenewschecker
danas.rs	news	wikidata
dandygoat.com	fakenews	fakenewschecker
danskestudier.dk	scientific	wikidata
danskteologisktidsskrift.dk	scientific	wikidata
darba-eja.com	scientific	wikidata
darkmoon.me	fakenews	fakenewschecker
darkpolitricks.com	fakenews	fakenewschecker
darpa.mil	usgov	usgov
darujps.com	scientific	wikidata
das.ct.gov	usgov	usgov
das.nh.gov	usgov	usgov
das.ohio.gov	usgov	usgov
das.sagepub.com	scientific	wikidata
data.bnf.fr	scientific	wikidata
data.gouv.fr	socialmedia	wikidata
database.oxfordjournals.org	scientific	wikidata
datz.de	scientific	wikidata
dau.mil	usgov	usgov
davidduke.com	fakenews	fakenewschecker
davidlender.net	blog	handcoded
davidsonia.org	scientific	wikidata
dawn.com	news	wikidata
dawsoncreekdailynews.ca	news	wikidata
dbm.sagepub.com	scientific	wikidata
dc.gov	usgov	usgov
dcaa.mil	usgov	usgov
dcboee.org	usgov	usgov
dcclothesline.com	fakenews	handcoded
dcexaminer.com	news	wikidata
dcgazette.com	fakenews	fakenewschecker|handcoded
dclottery.com	usgov	usgov
dcma.mil	usgov	usgov
dcor.state.ga.us	usgov	usgov
dcourier.com	news	wikidata
dcsa.mil	usgov	usgov
dcwhispers.com	fakenews	fakenewschecker
dds.ga.gov	usgov	usgov
deadline.com	news	handcoded
deadstate.org	blog	handcoded
deals.ebay.com	commercial	handcoded
debunkingskeptics.com	fakenews	fakenewschecker
decadrages.ch	scientific	wikidata
decaturdaily.com	news	wikidata
deccanchronicle.com	news	handcoded
deccanherald.com	news	handcoded
defenddemocracy.press	fakenews	fakenewschecker
defense.gov	usgov	usgov
defenselink.mil	usgov	usgov
defenseone.com	blog	handcoded
degruyter.com	scientific	wikidata
degruyter.de	scientific	wikidata
delaware.gov	usgov	usgov
delhinewsrecord.com	news	wikidata
delmnh.org	scientific	wikidata
delottery.com	usgov	usgov
democracynow.org	fakenews	fakenewschecker
democratandchronicle.com	news	wikidata
democraticunderground.com	fakenews	fakenewschecker
demographesqc.org	scientific	wikidata
demorgen.be	news	wikidata
denali.gov	usgov	usgov
denaro.it	news	wikidata
dennismichaellynch.com	fakenews	fakenewschecker
denverguardian.com	fakenews	handcoded
denverpost.com	news	wikidata
denverquarterly.com	scientific	wikidata
dep.state.fl.us	usgov	usgov
departed.co	fakenews	fakenewschecker
depauw.edu	scientific	wikidata
depts.drew.edu	scientific	wikidata
depts.washington.edu	scientific	wikidata
der-postillon.com	fakenews	handcoded
derecho.uba.ar	scientific	wikidata
derechoycienciapolitica.cl	scientific	wikidata
derfmagazine.com	fakenews	fakenewschecker|handcoded
dermatology.cdlib.org	scientific	wikidata
derpatriot.com	news	wikidata
derstandard.at	news	wikidata
deseretnews.com	news	wikidata
destak.pt	news	wikidata
destructoid.com	news	handcoded
deutscherkunstverlag.de	scientific	wikidata
dev.biologists.org	scientific	wikidata
dfa.arkansas.gov	usgov	usgov
dfa.ms.gov	usgov	usgov
dfas.mil	usgov	usgov
dgfo-articulata.de	scientific	wikidata
dgs.maryland.gov	usgov	usgov
dgs.pa.gov	usgov	usgov
dgs.virginia.gov	usgov	usgov
dhakatribune.com	news	wikidata
dhcon.ua.es	scientific	wikidata
dhnet.be	news	wikidata
dhpregie.com	scientific	wikidata
dhs.gov	usgov	usgov
dia.mil	usgov	usgov
diabetes.diabetesjournals.org	scientific	wikidata
diabetologia-journal.org	scientific	wikidata
dianoia.filosoficas.unam.mx	scientific	wikidata
diarideterrassa.es	news	wikidata
diariodeavila.es	news	wikidata
diariodesevilla.es	news	wikidata
diariojaen.es	news	wikidata
diariolasamericas.com	news	wikidata
diasporafoundation.org	socialmedia	wikidata
dif.unige.it	scientific	wikidata
digitalcommons.mcmaster.ca	scientific	wikidata
digitalcommons.wayne.edu	scientific	wikidata
digitallibrary.amnh.org	scientific	wikidata
digitaltrends.com	news	handcoded
dinamina.lk	news	wikidata
dio.sagepub.com	scientific	wikidata
dionee.org	scientific	wikidata
dir.commerce.gov	usgov	usgov
dir.texas.gov	usgov	usgov
directlille.com	news	wikidata
directmatin.fr	news	wikidata
directory.faa.gov	usgov	usgov
directsoir.net	news	wikidata
dirty.ru	blog	wikidata
disa.mil	usgov	usgov
disasterassistance.gov	usgov	usgov
disclose.tv	clickbait|fakenews	fakenewschecker|handcoded
disclosuremedia.net	fakenews	fakenewschecker
discoversouthcarolina.com	usgov	usgov
disputatio.com	scientific	wikidata
dissentmagazine.org	fakenews	fakenewschecker
divaina.com	news	wikidata
djmt.nl	scientific	wikidata
djoef-forlag.dk	scientific	wikidata
dl.sciencesocieties.org	scientific	wikidata
dla.mil	usgov	usgov
dlib.org	scientific	wikidata
dma.ens.fr	scientific	wikidata
dmd.aspetjournals.org	scientific	wikidata
dmm.biologists.org	scientific	wikidata
dms.myflorida	usgov	usgov
dms.sagepub.com	scientific	wikidata
dmtcs.org	scientific	wikidata
dmv.ca.gov	usgov	usgov
dmv.dc.gov	usgov	usgov
dmv.de.gov	usgov	usgov
dmv.nebraska.gov	usgov	usgov
dmv.ny.gov	usgov	usgov
dmv.ri.gov	usgov	usgov
dmv.state.pa.us	usgov	usgov
dmv.utah.gov	usgov	usgov
dmv.vermont.gov	usgov	usgov
dmv.virginia.gov	usgov	usgov
dmvnv.com	usgov	usgov
dn.se	news	wikidata
dna.fr	news	wikidata
dnaindia.com	news	wikidata|handcoded
dnaresearch.oxfordjournals.org	scientific	wikidata
dnews.com	news	wikidata
dnews.eu	news	wikidata
dni.gov	usgov	usgov
do.treas.gov	usgov	usgov
doa.alaska.gov	usgov	usgov
doa.az.gov	usgov	usgov
doa.la.gov	usgov	usgov
doa.state.nc.us	usgov	usgov
doa.state.wi.us	usgov	usgov
doas.ga.gov	usgov	usgov
doc-catho.com	scientific	wikidata
doc.dc.gov	usgov	usgov
doc.delaware.gov	usgov	usgov
doc.gov	usgov	usgov
doc.guam.gov	usgov	usgov
doc.ks.gov	usgov	usgov
doc.louisiana.gov	usgov	usgov
doc.mo.gov	usgov	usgov
doc.nv.gov	usgov	usgov
doc.ri.gov	usgov	usgov
doc.sc.gov	usgov	usgov
doc.sd.gov	usgov	usgov
doc.state.al.us	usgov	usgov
doc.state.co.us	usgov	usgov
doc.state.ia.us	usgov	usgov
doc.state.mn.us	usgov	usgov
doc.state.vt.us	usgov	usgov
doc.wa.gov	usgov	usgov
doc.wi.gov	usgov	usgov
doccs.ny.gov	usgov	usgov
dodiis.mil	usgov	usgov
doi.gov	usgov	usgov
dojmt.gov	usgov	usgov
dol.gov	usgov	usgov
dol.wa.gov	usgov	usgov
doleta.gov	usgov	usgov
dolomiten.it	news	wikidata
donotcall.gov	usgov	usgov
dor.mo.gov	usgov	usgov
dor.sd.gov	usgov	usgov
dos.myflorida.com	usgov	usgov
dos.pa.gov	usgov	usgov
dose.ca	news	handcoded
dossiersgrihl.revues.org	scientific	wikidata
dot.ca.gov	usgov	usgov
dot.gov	usgov	usgov
dot.nd.gov	usgov	usgov
dot.state.wy.us	usgov	usgov
dot.wisconsin.gov	usgov	usgov
dotclear.org	blog	wikidata
dothaneagle.com	news	wikidata
dovepress.com	scientific	wikidata
downtrend.com	fakenews	fakenewschecker
dpaa.mil	usgov	usgov
dps.gov.mp	usgov	usgov
dps.hawaii.gov	usgov	usgov
dps.mn.gov	usgov	usgov
dps.sagepub.com	scientific	wikidata
dps.state.ok.us	usgov	usgov
dpscs.state.md.us	usgov	usgov
drc.ohio.gov	usgov	usgov
dreamwidth.org	blog	wikidata
drivetribe.com	socialmedia	wikidata
drudgereport.com	fakenews	fakenewschecker
drudgereport.com.co	fakenews	handcoded
drugdiscoverytoday.com	scientific	wikidata
drupal.org	blog	wikidata
dsca.mil	usgov	usgov
dss.mil	usgov	usgov
dsshelp.org	usgov	usgov
dst.sagepub.com	scientific	wikidata
dtic.mil	usgov	usgov
dtra.mil	usgov	usgov
dts.edu	scientific	wikidata
dubois.fas.harvard.edu	scientific	wikidata
duffelblog.com	fakenews	fakenewschecker|handcoded
duffleblog.com	satire|fakenews	handcoded
duhprogressive.com	fakenews	fakenewschecker|handcoded
dujs.dartmouth.edu	scientific	wikidata
dukejournals.org	scientific	handcoded
dukeupress.edu	scientific	wikidata
duncker-humblot.de	scientific	wikidata
dvd.sagepub.com	scientific	wikidata
dvhn.nl	news	wikidata
dvr.sagepub.com	scientific	wikidata
dwxzz.ioz.ac.cn	scientific	wikidata
dx.doi.org	scientific	wikidata
e-asianwomen.org	scientific	wikidata
e-ijd.org	scientific	wikidata
e-journal.biologi.lipi.go.id	scientific	wikidata
e-revistas.uc3m.es	scientific	wikidata
e-spania.revues.org	scientific	wikidata
eab.sagepub.com	scientific	wikidata
eac.gov	usgov	usgov
eaglehill.us	scientific	wikidata
eaglerising.com	fakenews	fakenewschecker
eaq.sagepub.com	scientific	wikidata
earth-planets-space.com	scientific	wikidata
earthinteractions.org	scientific	wikidata
ease.org.uk	scientific	wikidata
ebaf.edu	scientific	wikidata
ebar.com	fakenews	fakenewschecker
ebay.com	commercial	handcoded
ebmh.bmj.com	scientific	wikidata
ebn.bmj.com	scientific	wikidata
ebtekarnews.com	news	wikidata
ebx.sagepub.com	scientific	wikidata
ec.asm.org	scientific	wikidata
ech-chaab.com	news	wikidata
echo-doran.com	news	wikidata
ecis.ie	scientific	wikidata
eclkc.ohs.acf.hhs.gov	usgov	usgov
ecologia.edu.mx	scientific	wikidata
ecologyandsociety.org	scientific	wikidata
econjwatch.org	scientific	wikidata
economics-sociology.eu	scientific	wikidata
economics.sas.upenn.edu	scientific	wikidata
economicsbulletin.com	scientific	wikidata
economist.com	news	handcoded
economyincrisis.org	fakenews	fakenewschecker
econtheory.org	scientific	wikidata
ecoscience.ulaval.ca	scientific	wikidata
ecp.ejpecp.org	scientific	wikidata
ecr.sagepub.com	scientific	wikidata
ecti.pennpress.org	scientific	wikidata
ecu.edu	scientific	wikidata
ed.gov	usgov	usgov
eda.gov	usgov	usgov
editions.bnf.fr	scientific	wikidata
editorialmanager.com	scientific	wikidata
edm.sagepub.com	scientific	wikidata
edmontonjournal.com	news	wikidata
edmontonsun.com	news	wikidata
edq.sagepub.com	scientific	wikidata
edr.sagepub.com	scientific	wikidata
edrv.endojournals.org	scientific	wikidata
eds.ieee.org	scientific	wikidata
eds.org.rs	scientific	wikidata
edu.zndxzk.com.cn	scientific	wikidata
edublogs.org	blog	handcoded
educatejournal.org	scientific	wikidata
education.com	commercial	handcoded
eeoc.gov	usgov	usgov
eff.org	news	handcoded
eforms.doi.gov	usgov	usgov
eforms.state.gov	usgov	usgov
egov.com	usgov	usgov
egov.uscis.gov	usgov	usgov
ehawaii.gov	usgov	usgov
ehjournal.net	scientific	wikidata
ehp.sagepub.com	scientific	wikidata
ehp03.niehs.nih.gov	scientific	wikidata
ehu.eus	scientific	wikidata
eia.doe.gov	usgov	usgov
eia.gov	usgov	usgov
eid.sagepub.com	scientific	wikidata
ejcancer.info	scientific	wikidata
ejcr.org	scientific	wikidata
ejcts.oxfordjournals.org	scientific	wikidata
eje-online.org	scientific	wikidata
eje.cz	scientific	wikidata
ejinme.com	scientific	wikidata
ejkm.com	scientific	wikidata
ejournal.unam.mx	scientific	wikidata
ejournals.library.ualberta.ca	scientific	wikidata
ejp.ejpecp.org	scientific	wikidata
ejpc.eu.com	scientific	wikidata
ejtp.com	scientific	wikidata
ejves.com	scientific	wikidata
ejw.sagepub.com	scientific	wikidata
ekantipur.com	news	wikidata
elacil.com	news	wikidata
elbilad.net	news	wikidata
elcomercio.pe	news	wikidata
elcorreo.com	news	wikidata
elcorreoweb.es	news	wikidata
elcvia.cvc.uab.es	scientific	wikidata
eldercare.gov	usgov	usgov
eldia.es	news	wikidata
elect.ky.gov	usgov	usgov
elections.alaska.gov	usgov	usgov
elections.delaware.gov	usgov	usgov
elections.il.gov	usgov	usgov
elections.ny.gov	usgov	usgov
elections.state.md.us	usgov	usgov
elections.state.ri.us	usgov	usgov
elections.utah.gov	usgov	usgov
elections.virginia.gov	usgov	usgov
electrochem.org	scientific	wikidata
electrochemsci.org	scientific	wikidata
electronicimaging.spiedigitallibrary.org	scientific	wikidata
electronicmarkets.org	scientific	wikidata
elektronika.orf.pl	scientific	wikidata
elementsmagazine.org	scientific	wikidata
elgg.org	blog	wikidata
elheraldo.com.co	news	wikidata
elifesciences.org	scientific	wikidata
elkoshary.com	fakenews	handcoded
ellecanada.com	news	handcoded
ellitoral.com	news	wikidata
ello.co	socialmedia	wikidata
elmoudjahid.com	news	wikidata
elmundo.com	news	wikidata
elmundo.es	news	wikidata
elmundotoday.com	fakenews	handcoded
elnervion.com	news	wikidata
elnortedecastilla.es	news	wikidata
elnuevoherald.com	news	wikidata
elpais.com	news	wikidata
elprofesionaldelainformacion.com	scientific	wikidata
elpunt.cat	news	wikidata
elpuntavui.cat	news	wikidata
elsalvador.com	news	wikidata
elsevier.com	scientific	wikidata|handcoded
elsevier.de	scientific	wikidata
elsevier.es	scientific	wikidata
elsevierhealth.com	scientific	handcoded
eltiempo.com	news	wikidata
eluniversal.com.mx	news	wikidata
eluniverso.com	news	wikidata
elwatan.com	news	wikidata
em-consulte.com	scientific	wikidata
em.doe.gov	usgov	usgov
em.oxfordjournals.org	scientific	wikidata
ema.sagepub.com	scientific	wikidata
embojournal.npgjournals.com	scientific	wikidata
embols.com	fakenews	fakenewschecker|handcoded
emeraldgrouppublishing.com	scientific	wikidata
emeraldinsight.com	scientific	wikidata
emf.sagepub.com	scientific	wikidata
emich.edu	scientific	wikidata
emis.de	scientific	wikidata
emj.bmj.com	scientific	wikidata
emol.com	news	wikidata
empireherald.com	fakenews	handcoded
empirenews.com	fakenews	fakenewschecker|handcoded
empirenews.net	fakenews	handcoded
empiresports.co	satire|fakenews	handcoded
emro.who.int	scientific	wikidata
ems-ph.org	scientific	wikidata
en.wikipedia.org	blog	handcoded
en.wikiversity.org	scientific	wikidata
endangered.fws.gov	usgov	usgov
endingthefed.com	fakenews	fakenewschecker|handcoded
endo.endojournals.org	scientific	wikidata
endoftheamericandream.com	fakenews	fakenewschecker
endtime.com	fakenews	fakenewschecker
enduringvision.com	fakenews	fakenewschecker|handcoded
energy.gov	usgov	usgov
enet.gr	news	wikidata
eng.sagepub.com	scientific	wikidata
engadget.com	news	handcoded
english.ivpp.cas.cn	scientific	wikidata
english.ufl.edu	scientific	wikidata
enim-egyptologie.fr	scientific	wikidata
enjoyillinois.com	usgov	usgov
entekhab.ir	news	wikidata
entomol.org	scientific	wikidata
entomologica.es	scientific	wikidata
entrecord.com	scientific	wikidata
entrepreneuriat.com	scientific	wikidata
entsoc.org	scientific	wikidata
entsocwash.org	scientific	wikidata
envplan.com	scientific	wikidata
envusmotors.com	commercial	handcoded
eonline.com	news	handcoded
eos.org	scientific	wikidata
ep.physoc.org	scientific	wikidata
epa.gov	usgov	usgov
epa.sagepub.com	scientific	wikidata
epaa.asu.edu	scientific	wikidata
epigeneticsandchromatin.com	scientific	wikidata
epilepsia.com	scientific	wikidata
epilepsybehavior.com	scientific	wikidata
epilepticdisorders.com	scientific	wikidata
epirev.oxfordjournals.org	scientific	wikidata
epj.org	scientific	wikidata
epjdatascience.springeropen.com	scientific	wikidata
epjournal.net	scientific	wikidata
epl.delfi.ee	news	wikidata
eplasty.com	scientific	wikidata
epm.sagepub.com	scientific	wikidata
epochtimes.com	news	wikidata
eps.revues.org	scientific	wikidata
epubs.icar.org.in	scientific	wikidata
epx.sagepub.com	scientific	wikidata
equinoxjournals.com	scientific	wikidata
equinoxpub.com	scientific	wikidata
erc.endocrinology-journals.org	scientific	wikidata
erenlai.com	scientific	wikidata
erevistas.saber.ula.ve	scientific	wikidata
erg.sagepub.com	scientific	wikidata
eric.ed.gov	usgov	usgov
erica.demon.co.uk	scientific	wikidata
ermt.net	scientific	wikidata
ers.usda.gov	usgov	usgov
erx.sagepub.com	scientific	wikidata
es.viadeo.com	socialmedia	wikidata
esa.doc.gov	usgov	usgov
esajournals.org	scientific	wikidata
esapubs.org	scientific	wikidata
escapistmagazine.com	news	handcoded
esj.sagepub.com	scientific	wikidata
espacepolitique.revues.org	scientific	wikidata
espritcreateur.umn.edu	scientific	wikidata
esq.org.au	scientific	wikidata
esquire.com	news	handcoded
ess.fi	news	wikidata
essor.ml	news	wikidata
est.sagepub.com	scientific	wikidata
estadistica.unal.edu.co	scientific	wikidata
estrepublicain.fr	news	wikidata
estudiosamericanos.revistas.csic.es	scientific	wikidata
estudiosdeasiayafrica.colmex.mx	scientific	wikidata
estudiosgallegos.revistas.csic.es	scientific	wikidata
estudioshumanisticos.org	scientific	wikidata
estudiosmedievales.revistas.csic.es	scientific	wikidata
estudiosnietzsche.org	scientific	wikidata
etc.se	news	wikidata
etcanada.com	news	handcoded
eth.sagepub.com	scientific	wikidata
ethicsandinternationalaffairs.org	scientific	wikidata
etn.sagepub.com	scientific	wikidata
etsy.com	commercial	handcoded
ettelaat.com	news	wikidata
etudesafricaines.revues.org	scientific	wikidata
etudesrurales.revues.org	scientific	wikidata
etyka.uw.edu.pl	scientific	wikidata
eu.wiley.com	scientific	wikidata
eucom.mil	usgov	usgov
eujournal.org	scientific	wikidata
eupjournals.com	scientific	wikidata
euppublishing.com	scientific	wikidata
eur.sagepub.com	scientific	wikidata
eurekalert.org	news	handcoded
eurheartj.oxfordjournals.org	scientific	wikidata
eurjmedres.com	scientific	wikidata
eurjmin.geoscienceworld.org	scientific	wikidata
eurogamer.net	news	handcoded
europace.oxfordjournals.org	scientific	wikidata
european-journal.org	scientific	wikidata
europeanjournaloftaxonomy.eu	scientific	wikidata
europeanneuropsychopharmacology.com	scientific	wikidata
europeanreview.org	scientific	wikidata
europeanurology.com	scientific	wikidata
europetodayonline.com	news	wikidata
europolitique.info	news	wikidata
eurosurveillance.org	scientific	wikidata
eurpub.oxfordjournals.org	scientific	wikidata
eutimes.net	fakenews	fakenewschecker
eveningexpress.co.uk	news	wikidata
eveningtimes.co.uk	news	wikidata
evi.sagepub.com	scientific	wikidata
ew.com	news	handcoded
ewao.com	fakenews	fakenewschecker
ewh.ieee.org	scientific	wikidata
excessiveleadseveryday.com	commercial	handcoded
exchanges.state.gov	usgov	usgov
existenz.us	scientific	wikidata
exoplatform.com	blog	wikidata
exoticpetmedicine.com	scientific	wikidata
experiencewa.com	usgov	usgov
exphem.org	scientific	wikidata
exploregeorgia.org	usgov	usgov
exploreminnesota.com	usgov	usgov
exponentcms.org	blog	wikidata
export.gov	usgov	usgov
express.co.uk	news	wikidata
expressen.se	news	wikidata
ext.sagepub.com	scientific	wikidata
extension.org	usgov	usgov
extrapolation.liverpooluniversitypress.co.uk	scientific	wikidata
eymj.org	scientific	wikidata
ezinearticles.com	blog	handcoded
f1000research.com	scientific	wikidata
faa.gov	usgov	usgov
facebook.com	socialmedia	wikidata|handcoded
factsreports.revues.org	scientific	wikidata
faculty.fordham.edu	scientific	wikidata
fahrenheitmagazine.com	scientific	wikidata
fakingnews.com	fakenews	fakenewschecker|handcoded
familysecuritymatters.org	fakenews	fakenewschecker
fampra.oupjournals.org	scientific	wikidata
fandalism.com	socialmedia	wikidata
fanniemae.com	usgov	usgov
fanpage.it	news	wikidata
fao.org	scientific	wikidata
faq.ssa.gov	usgov	usgov
fas.sagepub.com	scientific	wikidata
fas.usda.gov	usgov	usgov
fasab.gov	usgov	usgov
fasebj.org	scientific	wikidata
faz.net	news	wikidata
fb.me	commercial	handcoded
fbi.gov	usgov	usgov
fbr.sagepub.com	scientific	wikidata
fbs.org.au	scientific	wikidata
fc.eop.gov	usgov	usgov
fc2.com	blog	handcoded
fca.gov	usgov	usgov
fcc.gov	usgov	usgov
fcg.gov	usgov	usgov
fcs.revues.org	scientific	wikidata
fcsic.gov	usgov	usgov
fcx.sagepub.com	scientific	wikidata
fda.gov	usgov	usgov
fdic.gov	usgov	usgov
fdlreporter.com	news	wikidata
fe.doe.gov	usgov	usgov
feb.gov	usgov	usgov
febsjournal.org	scientific	wikidata
fec.gov	usgov	usgov
federalistpress.com	fakenews	fakenewschecker
federallabs.org	usgov	usgov
federalreserve.gov	usgov	usgov
federalreserveconsumerhelp.gov	usgov	usgov
fedstats.sites.usa.gov	usgov	usgov
feedblitz.com	news	handcoded
feedburner.com	news	handcoded
feeds.feedburner.com	blog	handcoded
feeds.huffingtonpost.com	news	handcoded
feedsportal.com	news	handcoded
feeries.revues.org	scientific	wikidata
fellowshipoftheminds.com	fakenews	fakenewschecker
fema.gov	usgov	usgov
feministeconomics.org	scientific	wikidata
fenbilimleri.sdu.edu.tr	scientific	wikidata
ferc.gov	usgov	usgov
ffiec.gov	usgov	usgov
fftsecurity.com	scientific	wikidata
fg.uni-mb.si	scientific	wikidata
fgdc.gov	usgov	usgov
fhaoutreach.com	usgov	usgov
fhfa.gov	usgov	usgov
fhwa.dot.gov	usgov	usgov
fi.mimuw.edu.pl	scientific	wikidata
fictioninc.com	scientific	wikidata
fictioninternational.com	scientific	wikidata
fieldmuseum.org	scientific	wikidata
filcasop.flu.cas.cz	scientific	wikidata
filmquarterly.org	scientific	wikidata
filosofia.unimi.it	scientific	wikidata
filosofianeoscolastica.vitaepensiero.it	scientific	wikidata
finance.ky.gov	usgov	usgov
financialexpress.com	news	handcoded
financialpost.com	news	handcoded
findahealthcenter.hrsa.gov	usgov	usgov
firescience.gov	usgov	usgov
firstmonday.org	scientific	wikidata
firstpost.com	news	handcoded
fiscal.treasury.gov	usgov	usgov
fiscalcommission.gov	usgov	usgov
fishbull.noaa.gov	scientific	wikidata
fitness.gov	usgov	usgov
fivethirtyeight.com	news	handcoded
fjc.gov	usgov	usgov
fla.sagepub.com	scientific	wikidata
flalottery.com	usgov	usgov
flensborg-avis.de	news	wikidata
fletc.gov	usgov	usgov
fletcher.tufts.edu	scientific	wikidata
flgov.com	usgov	usgov
flhsmv.gov	usgov	usgov
flickr.com	socialmedia|videos	wikidata
flipboard.com	blog	handcoded
flock.com	blog	wikidata
floodsmart.gov	usgov	usgov
florabase.dec.wa.gov.au	scientific	wikidata
floramontiberica.wordpress.com	scientific	wikidata
floridamedia.org	scientific	wikidata
floridareview.cah.ucf.edu	scientific	wikidata
flra.gov	usgov	usgov
fmc.gov	usgov	usgov
fmcs.gov	usgov	usgov
fmcsa.dot.gov	usgov	usgov
fmobserver.com	fakenews	fakenewschecker
fmpm.org	scientific	wikidata
fmshrc.gov	usgov	usgov
fmx.sagepub.com	scientific	wikidata
fnb.sagepub.com	scientific	wikidata
fncv.org.au	scientific	wikidata
fns.usda.gov	usgov	usgov
foa.sagepub.com	scientific	wikidata
focm-society.org	scientific	wikidata
focus.aps.org	scientific	wikidata
fognews.ru	fakenews	handcoded
foi.sagepub.com	scientific	wikidata
folha.com.br	news	wikidata
fonduaunoir44.blogspot.com	scientific	wikidata
forbes.com	news	handcoded
forctr.com	blog	handcoded
forecasters.org	scientific	wikidata
foreignpolicy.com	news	handcoded
fortaleza.pr.gov	usgov	usgov
fortunecity.com	blog	handcoded
forumdesas.cd	news	wikidata
forums.nexopia.com	socialmedia	wikidata
forwardprogressives.com	fakenews	fakenewschecker
fossil-record.net	scientific	wikidata
fossil.energy.gov	usgov	usgov
foursquare.com	socialmedia	wikidata
fourthriver.chatham.edu	scientific	wikidata
foxnews.com	news	handcoded
fpri.org	scientific	wikidata
fprnradio.com	clickbait|fakenews	handcoded
fq.math.ca	scientific	wikidata
fr-online.de	news	wikidata
fra.dot.gov	usgov	usgov
france.attac.org	scientific	wikidata
franceguyane.fr	news	wikidata
francesoir.fr	news	wikidata
freddiemac.com	usgov	usgov
freebeacon.com	fakenews	fakenewschecker
freedomdaily.com	fakenews	fakenewschecker
freedomoutpost.com	fakenews	fakenewschecker
freewebs.com	blog	handcoded
freewoodpost.com	fakenews	fakenewschecker|handcoded
freiepresse.de	news	wikidata
frenchreview.frenchteachers.org	scientific	wikidata
frenchstudies.research.yale.edu	scientific	wikidata
freundpublishing.com	scientific	wikidata
fridaymash.com	fakenews	fakenewschecker
friendica.com	socialmedia	wikidata
friendster.com	blog|socialmedia	wikidata|handcoded
fromthetrenchesworldreport.com	fakenews	fakenewschecker
front.moveon.org	fakenews	fakenewschecker
frontiers.osu.edu	scientific	wikidata
frontiersin.org	scientific	wikidata|handcoded
frontiersinecology.org	scientific	wikidata
frontiersinzoology.com	scientific	wikidata
frontline.in	news	handcoded
frtib.gov	usgov	usgov
fs.fed.us	usgov	usgov
fs.oxfordjournals.org	scientific	wikidata
fsa.usda.gov	usgov	usgov
fsb.oxfordjournals.org	scientific	wikidata
fsigenetics.com	scientific	wikidata
fsijournal.org	scientific	wikidata
fsis.usda.gov	usgov	usgov
fsmgov.org	usgov	usgov
fsp.idaho.gov	usgov	usgov
ft.com	news	wikidata|handcoded
ft.lk	news	wikidata
fta.dot.gov	usgov	usgov
ftc.gov	usgov	usgov
ftccomplaintassistant.gov	usgov	usgov
ftd.de	news	wikidata
fty.sagepub.com	scientific	wikidata
fuldaerzeitung.de	news	wikidata
fulltextrssfeed.com	news	handcoded
functionalecology.org	scientific	wikidata
funk.net	socialmedia|videos	wikidata
fupress.com	scientific	wikidata
fupress.net	scientific	wikidata
futuremedicine.com	scientific	wikidata
fvap.gov	usgov	usgov
fw.to	commercial	handcoded
fws.gov	usgov	usgov
g3journal.org	scientific	wikidata
ga-online.de	news	wikidata
gab.wi.gov	usgov	usgov
gacetasanitaria.org	scientific	wikidata
gadsdentimes.com	news	wikidata
gaia-online.net	scientific	wikidata
gallica2.bnf.fr	scientific	wikidata
galottery.com	usgov	usgov
gamasutra.com	news	handcoded
gamepolitics.com	blog|news	wikidata|handcoded
gamesindustry.biz	news	handcoded
gamespot.com	news	handcoded
gamesradar.com	news	handcoded
gametrailers.com	news	handcoded
gamingpost.ca	news	handcoded
gangstergovernment.com	fakenews	fakenewschecker
gao.gov	usgov	usgov
gaq.sagepub.com	scientific	wikidata
gargoylemagazine.com	scientific	wikidata
gas.sagepub.com	scientific	wikidata
gastrointestinalnursing.co.uk	scientific	wikidata
gastrojournal.org	scientific	wikidata
gastronomica.org	scientific	wikidata
gather.com	blog	handcoded
gawker.com	news	handcoded
gazeta-pravda.ru	news	wikidata
gazette.com	news	wikidata
gazettelive.co.uk	news	wikidata
gazzetta.it	news	wikidata
gazzettadasti.it	news	wikidata
gazzettadimantova.it	news	wikidata
gazzettadireggio.gelocal.it	news	wikidata
gbr.sagepub.com	scientific	wikidata
gcq.sagepub.com	scientific	wikidata
gct.sagepub.com	scientific	wikidata
gd.se	news	wikidata
gdp.ch	news	wikidata
gec.guam.gov	usgov	usgov
gecarbon.org	scientific	wikidata
geek.com	news	handcoded
geiselmed.dartmouth.edu	scientific	wikidata
generalservices.state.nm.us	usgov	usgov
genesandnutrition.biomedcentral.com	scientific	wikidata
genesdev.cshlp.org	scientific	wikidata
genetics.org	scientific	wikidata
genome.cshlp.org	scientific	wikidata
genomebiology.com	scientific	wikidata
geoengineeringwatch.org	clickbait|fakenews	fakenewschecker|handcoded
geofisica.unam.mx	scientific	wikidata
geolmag.geoscienceworld.org	scientific	wikidata
geologi.no	scientific	wikidata
geologica.org.ar	scientific	wikidata
geology.cz	scientific	wikidata
geology.gsapubs.org	scientific	wikidata
geolsoc.org.uk	scientific	wikidata
georgia.gov	usgov	usgov
geoscientific-model-development.net	scientific	wikidata
geotar.ru	scientific	wikidata
gettysburgreview.com	scientific	wikidata
gh.oxfordjournals.org	scientific	wikidata
ghost.org	blog	wikidata|handcoded
ghpjournal.com	scientific	wikidata
gia.edu	scientific	wikidata
giantbomb.com	news	handcoded
gigaom.com	news	handcoded
gigasciencejournal.com	scientific	wikidata
ginniemae.gov	usgov	usgov
giornaledeglieconomisti.unibocconi.it	scientific	wikidata
giornaledibergamo.com	news	wikidata
giornaledibrescia.it	news	wikidata
giornaledicalabria.net	news	wikidata
gipsa.usda.gov	usgov	usgov
gizmodo.com	news	handcoded
gji.oxfordjournals.org	scientific	wikidata
gladius.revistas.csic.es	scientific	wikidata
glamour.com	news	handcoded
glimmertrain.com	scientific	wikidata
globaldrugpolicy.org	scientific	wikidata
globalizationandhealth.com	scientific	wikidata
globalnews.ca	news	handcoded
globalpolicyjournal.com	scientific	wikidata
globalresearch.ca	clickbait|fakenews	fakenewschecker|handcoded
globaltimes.cn	news	wikidata
globes.co.il	news	wikidata
glossynews.com	fakenews	fakenewschecker
glq.dukejournals.org	scientific	wikidata
glycob.oxfordjournals.org	scientific	wikidata
gmc.sagepub.com	scientific	wikidata
gmt.sagepub.com	scientific	wikidata
gnu.io	blog	wikidata
go.com	news	handcoded
goang.com	usgov	usgov
goarmy.com	usgov	usgov
gofundme.com	commercial	handcoded
gohawaii.com	usgov	usgov
gom.sagepub.com	scientific	wikidata
gomerblog.com	satire|fakenews	fakenewschecker|handcoded
goneleft.com	fakenews	fakenewschecker
goo.gl	commercial	handcoded
good.is	news	handcoded
google.co.uk	blog	handcoded
google.com	blog	handcoded
gopthedailydose.com	fakenews	fakenewschecker
gos.sagepub.com	scientific	wikidata
gosanangelo.com	news	wikidata
goupstate.com	news	wikidata
gov.alaska.gov	usgov	usgov
gov.georgia.gov	usgov	usgov
gov.idaho.gov	usgov	usgov
gov.louisiana.gov	usgov	usgov
gov.mp	usgov	usgov
gov.nv.gov	usgov	usgov
gov.texas.gov	usgov	usgov
governor.alabama.gov	usgov	usgov
governor.arkansas.gov	usgov	usgov
governor.delaware.gov	usgov	usgov
governor.guam.gov	usgov	usgov
governor.hawaii.gov	usgov	usgov
governor.iowa.gov	usgov	usgov
governor.ks.gov	usgov	usgov
governor.maryland.gov	usgov	usgov
governor.mo.gov	usgov	usgov
governor.mt.gov	usgov	usgov
governor.nc.gov	usgov	usgov
governor.nd.gov	usgov	usgov
governor.nebraska.gov	usgov	usgov
governor.nh.gov	usgov	usgov
governor.ny.gov	usgov	usgov
governor.ohio.gov	usgov	usgov
governor.pa.gov	usgov	usgov
governor.ri.gov	usgov	usgov
governor.sc.gov	usgov	usgov
governor.state.nm.us	usgov	usgov
governor.vermont.gov	usgov	usgov
governor.virginia.gov	usgov	usgov
governor.wa.gov	usgov	usgov
governor.wv.gov	usgov	usgov
governor.wyo.gov	usgov	usgov
governorbryant.com	usgov	usgov
goviamedia.com	scientific	wikidata
govnews.ca.gov	usgov	usgov
govtslaves.info	clickbait|fakenews	fakenewschecker|handcoded
gpo.gov	usgov	usgov
granma.cu	news	wikidata
grantland.com	news	handcoded
grants.gov	usgov	usgov
grasasyaceites.revistas.csic.es	scientific	wikidata
gravelocator.cem.va.gov	usgov	usgov
greanvillepost.com	fakenews	fakenewschecker
greatlakes-seaway.com	usgov	usgov
greenbaypressgazette.com	news	wikidata
greenbranch.com	scientific	wikidata
greenmountainsreview.com	scientific	wikidata
greenpharmacy.info	scientific	wikidata
greensbororeview.org	scientific	wikidata
griffithreview.com	scientific	wikidata
grist.org	news	handcoded
groupelareference.afrikart.net	news	wikidata
groupelavenir.net	news	wikidata
groupes.polymtl.ca	scientific	wikidata
grupointramuros.com	scientific	wikidata
gsa.gov	usgov	usgov
gsp.sagepub.com	scientific	wikidata
gss.omb.delaware.gov	usgov	usgov
gtd.sagepub.com	scientific	wikidata
guam.gov	usgov	usgov
guamag.org	usgov	usgov
guamtax.com	usgov	usgov
guelphmercury.com	news	wikidata
gulagbound.com	clickbait|fakenews	fakenewschecker|handcoded
gulf-daily-news.com	news	wikidata
gulfnews.com	news	wikidata
gulfpetrolink.com	scientific	wikidata
gupress.gallaudet.edu	scientific	wikidata
gut.bmj.com	scientific	wikidata
gwu.edu	scientific	wikidata
h-net.org	scientific	wikidata
haaretz.co.il	news	wikidata
haaretz.com	news	wikidata
habariproject.org	blog	wikidata
hadashot-esi.org.il	scientific	wikidata
haematologica.org	scientific	wikidata
hahr.dukejournals.org	scientific	wikidata
hakirah.org	scientific	wikidata
handelsblatt.com	news	wikidata
hangthebankers.com	clickbait|fakenews	fakenewschecker|handcoded
hapr.org	scientific	wikidata
hararetribune.com	news	wikidata
harmreductionjournal.com	scientific	wikidata
harpurpalate.binghamton.edu	scientific	wikidata
harrassowitz-verlag.de	scientific	wikidata
harvard.edu	news	handcoded
harvardbusiness.org	news	handcoded
havre-libre.fr	news	wikidata
hawaii.edu	scientific	wikidata
hawaii.gov	usgov	usgov
hawaiiaudubon.org	scientific	wikidata
hawaiitribune-herald.com	news	wikidata
haydensferryreview.com	scientific	wikidata
hbl.fi	news	wikidata
hbs.bishopmuseum.org	scientific	wikidata
hcjournal.org	scientific	wikidata
hcommons.org	socialmedia	wikidata
hdl.handle.net	scientific	wikidata
healio.com	scientific	wikidata
health.com	news	handcoded
health.gov	usgov	usgov
healthaffairs.org	scientific	wikidata
healthcareitnews.com	news	handcoded
healthfinder.gov	usgov	usgov
healthimpactnews.com	fakenews	fakenewschecker
healthpolicyandtechnology.org	scientific	wikidata
healthpolicyjrnl.com	scientific	wikidata
healthunlocked.com	socialmedia	wikidata
heartjnl.com	scientific	wikidata
heb.sagepub.com	scientific	wikidata
helpwithmybank.gov	usgov	usgov
helsinki.fi	scientific	wikidata
helv.wiley.com	scientific	wikidata
henrymakow.com	fakenews	fakenewschecker
hepatitisbannual.org	scientific	wikidata
hepg.org	scientific	wikidata
her.oxfordjournals.org	scientific	wikidata
herald.ie	news	wikidata
heraldscotland.com	news	wikidata
heraldsun.com.au	news	wikidata
heraldtribune.com	news	wikidata
herder-institut.de	scientific	wikidata
herodote.org	scientific	wikidata
herp-or.uv.ro	scientific	wikidata
hetcomm.tripod.com	scientific	wikidata
heterocycles.jp	scientific	wikidata
hetvolk.be	news	wikidata
heuteonline.ch	news	wikidata
hgp.sagepub.com	scientific	wikidata
hgtv.ca	news	handcoded
hhrjournal.org	scientific	wikidata
hhs.gov	usgov	usgov
hidot.hawaii.gov	usgov	usgov
highbeam.com	scientific	wikidata
highereducationreview.com	scientific	wikidata
hildesheimer-allgemeine.de	news	wikidata
hillaryclinton.com	commercial	handcoded
hilltimes.com	news	handcoded
himalmag.com	scientific	wikidata
hindawi.com	scientific	wikidata|handcoded
hindustantimes.com	news	handcoded
hip.sagepub.com	scientific	wikidata
hispanianova.rediris.es	scientific	wikidata
hispaniasacra.revistas.csic.es	scientific	wikidata
histoire-politique.fr	scientific	wikidata
histoiremesure.revues.org	scientific	wikidata
historia-actual.org	scientific	wikidata
historiaagraria.com	scientific	wikidata
historiasocial.es	scientific	wikidata
historicalmaterialism.org	scientific	wikidata
historischegaerten.de	scientific	wikidata
historisktidsskrift.dk	scientific	wikidata
historyofscience.jp	scientific	wikidata
hitfix.com	news	handcoded
hjas.org	scientific	wikidata
hjb.sagepub.com	scientific	wikidata
hjmed.org	scientific	wikidata
hjms.hacettepe.edu.tr	scientific	wikidata
hjnews.com	news	wikidata
hk.apple.nextmedia.com	news	wikidata
hk.humankinetics.com	scientific	wikidata
hljournals.org	scientific	wikidata
hln.be	news	wikidata
hmg.oxfordjournals.org	scientific	wikidata
hna.de	news	wikidata
hochi.co.jp	news	wikidata
hogrefe.com	scientific	wikidata
hokkaido-np.co.jp	news	wikidata
hol.sagepub.com	scientific	wikidata
hollywood.com	news	handcoded
hollywoodreporter.com	news	handcoded
home.ewha.ac.kr	scientific	wikidata
home.twibble.io	commercial	handcoded
home.vef.gov	usgov	usgov
homeopathyjournal.net	scientific	wikidata
hometownjournal.biz	news	wikidata
homooeconomicus.org	scientific	wikidata
horizonpress.com	scientific	wikidata
horizons-dz.com	news	wikidata
hospitality.fiu.edu	scientific	wikidata
hospitalpracticemed.com	scientific	wikidata
host.madison.com	news	wikidata
hotlist.com	blog	wikidata
houmatoday.com	news	wikidata
house.gov	usgov	usgov
howdovaccinescauseautism.com	blog	handcoded
howstuffworks.com	news	handcoded
howtogeek.com	news	handcoded
hpp.sagepub.com	scientific	wikidata
hpy.sagepub.com	scientific	wikidata
hq.doe.gov	usgov	usgov
hq.nasa.gov	usgov	usgov
hqdainet.army.mil	usgov	usgov
hr.pennpress.org	scientific	wikidata
hrd.sagepub.com	scientific	wikidata
hrsa.gov	usgov	usgov
hs.fi	news	wikidata
hsb.sagepub.com	scientific	wikidata
hsj.co.uk	scientific	wikidata
hsm.sagepub.com	scientific	wikidata
hsr.org	scientific	wikidata
hsx.sagepub.com	scientific	wikidata
ht.ly	commercial	handcoded
ht.no	news	wikidata
hta.ac.uk	scientific	wikidata
hth.sagepub.com	scientific	wikidata
hud.gov	usgov	usgov
hudsonreview.com	scientific	wikidata
huduser.org	usgov	usgov
huffingtonpost.ca	news	handcoded
huffingtonpost.com	news	handcoded
huffingtonpost.it	news	wikidata
huh.harvard.edu	scientific	wikidata
hum.huji.ac.il	scientific	wikidata
human-resources-health.com	scientific	wikidata
humanaffairs.sk	scientific	wikidata
humanamente.eu	scientific	wikidata
humanevents.com	news	handcoded
humanisme-et-entreprise.asso-web.com	scientific	wikidata
humanite.fr	news	wikidata
humansarefree.com	clickbait|fakenews	fakenewschecker|handcoded
humantechnology.jyu.fi	scientific	wikidata
humestudies.org	scientific	wikidata
humortimes.com	fakenews	fakenewschecker
humrep.oxfordjournals.org	scientific	wikidata
hungermtn.org	scientific	wikidata
hunter.cuny.edu	scientific	wikidata
hurriyet.com.tr	news	wikidata
hut.sagepub.com	scientific	wikidata
huzlers.com	satire|fakenews	fakenewschecker|handcoded
hw.oeaw.ac.at	scientific	wikidata
hydrology-and-earth-system-sciences.net	scientific	wikidata
hyper.ahajournals.org	scientific	wikidata
hypodiab.com	scientific	wikidata
i-journals.org	scientific	wikidata
iab.sagepub.com	scientific	wikidata
iacr.org	scientific	wikidata
iaee.org	scientific	wikidata
iaf-world.org	scientific	wikidata
iaf.gov	usgov	usgov
iai.asm.org	scientific	wikidata
ialottery.com	usgov	usgov
iandc.csail.mit.edu	scientific	wikidata
iands.org	scientific	wikidata
iaprisonind.com	usgov	usgov
ias.ac.in	scientific	wikidata
iasc-culture.org	scientific	wikidata
ibis.ac.uk	scientific	wikidata
ibr-bbr.org	scientific	wikidata
ibtimes.co.uk	news	handcoded
ibtimes.com	news	handcoded
icb.oxfordjournals.org	scientific	wikidata
ice.gov	usgov	usgov
ich.gov	usgov	usgov
icheme.org	scientific	wikidata
ichf.edu.pl	scientific	wikidata
icie.zkm.de	scientific	wikidata
icm.csic.es	scientific	wikidata
icmjournal.esicm.org	scientific	wikidata
icq.com	socialmedia	wikidata
icr.uexternado.edu.co	scientific	wikidata
idaho.gov	usgov	usgov
idaholottery.com	usgov	usgov
idahopress.com	news	wikidata
idahostatesman.com	news	wikidata
ideas.live.com	blog	wikidata
ideasyvalores.unal.edu.co	scientific	wikidata
identi.ca	socialmedia	wikidata
idescat.cat	scientific	wikidata
idoc.idaho.gov	usgov	usgov
idoc.state.il.us	usgov	usgov
ids.thomsonreuters.com	scientific	wikidata
idunn.no	scientific	wikidata
idv.sagepub.com	scientific	wikidata
ieee-awpl.eecs.qmul.ac.uk	scientific	wikidata
ieee-ceda.org	scientific	wikidata
ieee-sensors.org	scientific	wikidata
ieee.org	scientific	wikidata
ieeeaps.org	scientific	wikidata
ieeecss.org	scientific	wikidata
ieeemagnetics.org	scientific	wikidata
ieeexplore.ieee.org	scientific	wikidata
iehca.eu	scientific	wikidata
iel.vscht.cz	scientific	wikidata
ies.ed.gov	usgov	usgov
ifl.sagepub.com	scientific	wikidata
iflscience.com	blog	handcoded
ifors.org	scientific	wikidata
ifporient.org	scientific	wikidata
ifyouonlynews.com	fakenews	fakenewschecker|handcoded
igi-global.com	scientific	wikidata
igme.es	scientific	wikidata
ign.com	news	handcoded
ignet.gov	usgov	usgov
ihaf.qc.ca	scientific	wikidata
ihavethetruth.com	fakenews	fakenewschecker
iheu.org	scientific	wikidata
ihs.gov	usgov	usgov
iiac.cnrs.fr	scientific	wikidata
iibf.sdu.edu.tr	scientific	wikidata
iijournals.com	scientific	wikidata
ijaaworld.com	scientific	wikidata
ijact.org	scientific	wikidata
ijaweb.org	scientific	wikidata
ijb.sagepub.com	scientific	wikidata
ijbnpa.org	scientific	wikidata
ijcaonline.org	scientific	wikidata
ijcb.org	scientific	wikidata
ijccm.org	scientific	wikidata
ijce.iust.ac.ir	scientific	wikidata
ijcm.org.in	scientific	wikidata
ijdb.ehu.es	scientific	wikidata
ijdp.org	scientific	wikidata
ijdr.in	scientific	wikidata
ijdvl.com	scientific	wikidata
ije.oxfordjournals.org	scientific	wikidata
ijer.ir	scientific	wikidata
ijfab.org	scientific	wikidata
ijfs.usb.ac.ir	scientific	wikidata
ijg.sagepub.com	scientific	wikidata
ijhg.com	scientific	wikidata
ijims.ms.tku.edu.tw	scientific	wikidata
ijism.ricest.ac.ir	scientific	wikidata
ijl.oxfordjournals.org	scientific	wikidata
ijl.sagepub.com	scientific	wikidata
ijlm.net	scientific	wikidata
ijm.sagepub.com	scientific	wikidata
ijmes.chass.ncsu.edu	scientific	wikidata
ijmm.org	scientific	wikidata
ijmpo.org	scientific	wikidata
ijmr.org.in	scientific	wikidata
ijms.nova.edu	scientific	wikidata
ijmsn.ir	scientific	wikidata
ijnp.oxfordjournals.org	scientific	wikidata
ijnr.ir	scientific	wikidata
ijnv.ir	scientific	wikidata
ijo.in	scientific	wikidata
ijo.sagepub.com	scientific	wikidata
ijoc.org	scientific	wikidata
ijoca.com	scientific	wikidata
ijoem.com	scientific	wikidata
ijoms.com	scientific	wikidata
ijoy.org.in	scientific	wikidata
ijp-online.com	scientific	wikidata
ijp.scbaghdad.edu.iq	scientific	wikidata
ijpm.info	scientific	wikidata
ijpmonline.org	scientific	wikidata
ijpn.ir	scientific	wikidata
ijpor.oxfordjournals.org	scientific	wikidata
ijps.org	scientific	wikidata
ijpsonline.com	scientific	wikidata
ijqhw.net	scientific	wikidata
ijr.com	fakenews	handcoded
ijr.sagepub.com	scientific	wikidata
ijri.org	scientific	wikidata
ijs.sagepub.com	scientific	wikidata
ijs.sgmjournals.org	scientific	wikidata
ijs.speleo.it	scientific	wikidata
ijsi.org	scientific	wikidata
ijstd.org	scientific	wikidata
ijt.sagepub.com	scientific	wikidata
ijtrichology.com	scientific	wikidata
ijts.tosok.or.kr	scientific	wikidata
ilaword.org	scientific	wikidata
ilcentro.gelocal.it	news	wikidata
ilcittadinomb.it	news	wikidata
ilcovile.it	scientific	wikidata
ildomani.it	news	wikidata
ildomanidibologna.it	news	wikidata
ilfattoquotidiano.it	news	wikidata
ilfoglio.it	news	wikidata
ilgiornale.it	news	wikidata
ilgiorno.it	news	wikidata
ilkka.fi	news	wikidata
illinois.gov	usgov	usgov
illinoislottery.com	usgov	usgov
illuminati-news.com	fakenews	fakenewschecker
ilmanifesto.info	news	wikidata
ilmattino.it	news	wikidata
ilmessaggero.it	news	wikidata
ilnuovocorriere.it	news	wikidata
ilpiccolo.it	news	wikidata
ilpost.it	news	wikidata
ilquotidianofvg.it	news	wikidata
ilrestodelcarlino.it	news	wikidata
ilroma.net	news	wikidata
ilromanista.it	news	wikidata
ilsecoloxix.it	news	wikidata
iltempo.it	news	wikidata
im.microbios.org	scientific	wikidata
ima.org.il	scientific	wikidata
imagejournal.org	scientific	wikidata
imath.kiev.ua	scientific	wikidata
imeche.org	scientific	wikidata
imh.org.rs	scientific	wikidata
imj.ie	scientific	wikidata
imls.gov	usgov	usgov
immunome-research.net	scientific	wikidata
imp.sagepub.com	scientific	wikidata
impactjournals.com	scientific	wikidata
imprint.co.uk	scientific	wikidata
improveirs.org	usgov	usgov
impublications.com	scientific	wikidata
imrn.oxfordjournals.org	scientific	wikidata
ims.cuhk.edu.hk	scientific	wikidata
imss.nl	scientific	wikidata
imstat.org	scientific	wikidata
in.com	news	handcoded
in.gov	usgov	usgov
inaugural.senate.gov	usgov	usgov
inc.com	news	handcoded
incomesdata.co.uk	scientific	wikidata
indecisionforever.com	fakenews	handcoded
independent.co.uk	news	wikidata
independent.ie	news	wikidata
independent.org	scientific	wikidata
inderscience.com	scientific	wikidata
india.com	news	handcoded
indiana.edu	scientific	wikidata
indianareview.org	scientific	wikidata
indianexpress.com	news	wikidata|handcoded
indianforester.org	scientific	wikidata
indianjcancer.com	scientific	wikidata
indianjgastro.com	scientific	wikidata
indianjmedsci.org	scientific	wikidata
indianjnephrol.org	scientific	wikidata
indianjpsychiatry.org	scientific	wikidata
indianjurol.com	scientific	wikidata
indiatimes.com	news	handcoded
ine.pt	scientific	wikidata
infinite-sushi.com	blog	wikidata
infiniteunknown.net	fakenews	fakenewschecker
info.ahrq.gov	usgov	usgov
info.emeraldinsight.com	scientific	wikidata
informahealthcare.com	scientific	wikidata
informapharmascience.com	scientific	wikidata
informationclearinghouse.info	fakenews	fakenewschecker
informationgrammaticale.com	scientific	wikidata
informationweek.com	news	handcoded
informaworld.com	scientific	wikidata
informs.org	scientific	wikidata
infostormer.com	fakenews	fakenewschecker
infowars.com	clickbait|fakenews	fakenewschecker|handcoded
ingentaconnect.com	scientific	wikidata
ini.sagepub.com	scientific	wikidata
injuryjournal.com	scientific	wikidata
injuryprevention.bmj.com	scientific	wikidata
ink.org	usgov	usgov
inkwelljournal.org	scientific	wikidata
inmabb.criba.edu.ar	scientific	wikidata
inorgsynth.com	scientific	wikidata
inpractice.bvapublications.com	scientific	wikidata
inquirer.com.ph	news	wikidata
inquiryjournal.org	scientific	wikidata
inquisitr.com	fakenews	handcoded
inscribe.iupress.org	scientific	wikidata
insects.demon.co.uk	scientific	wikidata
insidenova.com	news	wikidata
insider.foxnews.com	news	handcoded
insight-journal.org	scientific	wikidata
insightturkey.com	scientific	wikidata
instaar.colorado.edu	scientific	wikidata
instagram.com	socialmedia|videos	wikidata|handcoded
institucional.us.es	scientific	wikidata
institutions.ville-geneve.ch	scientific	wikidata
int-res.com	scientific	wikidata
intarchmed.com	scientific	wikidata
intellectbooks.co.uk	scientific	wikidata
intellihub.com	clickbait|fakenews	fakenewschecker|handcoded
interfacejournal.net	scientific	wikidata
interfaces.pubs.informs.org	scientific	wikidata
internationalbulletin.org	scientific	wikidata
internationalemergencynursing.com	scientific	wikidata
internationalshoulderjournal.org	scientific	wikidata
interrev.com	scientific	wikidata
interstices.ac.nz	scientific	wikidata
intertrends.ru	scientific	wikidata
inthealth.oxfordjournals.org	scientific	wikidata
intimm.oupjournals.org	scientific	wikidata
intjit.org	scientific	wikidata
intl-learnmem.cshlp.org	scientific	wikidata
intl.clinchem.org	scientific	wikidata
intlpress.com	scientific	wikidata
intmedpress.com	scientific	wikidata
intrendtoday.com	fakenews	fakenewschecker
intrepidreport.com	fakenews	fakenewschecker
investmentwatchblog.com	fakenews	fakenewschecker
iol.co.za	news	wikidata
iopscience.iop.org	scientific	wikidata
iopscience.org	scientific	wikidata
ios.doi.gov	usgov	usgov
iospress.nl	scientific	wikidata
iot.custhelp.com	usgov	usgov
iovs.org	scientific	wikidata
iowa.gov	usgov	usgov
iowadot.gov	usgov	usgov
iowareview.uiowa.edu	scientific	wikidata
ipeindia.org	scientific	wikidata
ipernity.com	socialmedia	wikidata
ipocan.it	scientific	wikidata
ips.2-d.jp	scientific	wikidata
irc-galleria.net	socialmedia	wikidata
irct.org	scientific	wikidata
iris.custhelp.com	usgov	usgov
irishexaminer.com	news	wikidata
irishnaturalistsjournal.org	scientific	wikidata
irishtimes.com	news	wikidata
irm.sagepub.com	scientific	wikidata
ironictimes.com	fakenews	fakenewschecker
irs.gov	usgov	usgov
irs.sagepub.com	scientific	wikidata
isb.sagepub.com	scientific	wikidata
isc.kharkov.com	scientific	wikidata
isc.sagepub.com	scientific	wikidata
iseas.edu.sg	scientific	wikidata
isko.org	scientific	wikidata
islamicanews.com	fakenews	fakenewschecker|handcoded
island.lk	news	wikidata
ismj.bpums.ac.ir	scientific	wikidata
isp.oxfordjournals.org	scientific	wikidata
isp.sagepub.com	scientific	wikidata
ispacs.com	scientific	wikidata
ispan.waw.pl	scientific	wikidata
isr.journal.informs.org	scientific	wikidata
isr.nus.edu.sg	scientific	wikidata
israelexplorationsociety.huji.ac.il	scientific	wikidata
israelhayom.co.il	news	wikidata
israelhayom.com	news	wikidata
israelislamandendtimes.com	fakenews	fakenewschecker
iss.co.za	scientific	wikidata
iss.sagepub.com	scientific	wikidata
issr-journals.org	scientific	wikidata
issues.org	scientific	wikidata
ista.univ-fcomte.fr	scientific	wikidata
istl.org	scientific	wikidata
isw.sagepub.com	scientific	wikidata
ita-savo.fi	news	wikidata
ita.doc.gov	usgov	usgov
itaglive.com	satire|fakenews	fakenewschecker|handcoded
italian-journal-of-mammalogy.it	scientific	wikidata
itbusiness.ca	news	handcoded
itd.idaho.gov	usgov	usgov
itidjournal.org	scientific	wikidata
itunes.apple.com	blog	wikidata
iucrj.org	scientific	wikidata
iumj.indiana.edu	scientific	wikidata
iupac.org	scientific	wikidata
iupress.indiana.edu	scientific	wikidata
ivi.sagepub.com	scientific	wikidata
iwim.uni-bremen.de	scientific	wikidata
j-alz.com	scientific	wikidata
j.sinap.ac.cn	scientific	wikidata
jaa.sagepub.com	scientific	wikidata
jaa.uconn.edu	scientific	wikidata
jaacap.com	scientific	wikidata
jaad.org	scientific	wikidata
jaapa.com	scientific	wikidata
jab.sagepub.com	scientific	wikidata
jabberwock.org.msstate.edu	scientific	wikidata
jabfm.org	scientific	wikidata
jac.oxfordjournals.org	scientific	wikidata
jacionline.org	scientific	wikidata
jackpineradicals.com	fakenews	fakenewschecker
jacksonville.com	news	wikidata
jacm.acm.org	scientific	wikidata
jacobinmag.com	fakenews	fakenewschecker
jacr.org	scientific	wikidata
jad.sagepub.com	scientific	wikidata
jae.oxfordjournals.org	scientific	wikidata
jaf.sagepub.com	scientific	wikidata
jag.sagepub.com	scientific	wikidata
jah.sagepub.com	scientific	wikidata
jaids.com	scientific	wikidata
jair.org	scientific	wikidata
jalc.de	scientific	wikidata
jama.ama-assn.org	scientific	wikidata
jamahir.alwehda.gov.sy	news	wikidata
jamanak.com	news	wikidata
jambo.africa.kyoto-u.ac.jp	scientific	wikidata
jamesmadison.gov	usgov	usgov
jamesmadison.scholarsapply.org	usgov	usgov
jamia.org	scientific	wikidata
jams-kpi.com	scientific	wikidata
janmorganmedia.com	fakenews	fakenewschecker
jaoa.org	scientific	wikidata
jap.aip.org	scientific	wikidata
jap.physiology.org	scientific	wikidata
jap.sagepub.com	scientific	wikidata
japanfocus.org	scientific	wikidata
japmaonline.org	scientific	wikidata
jar.sagepub.com	scientific	wikidata
jardincanario.org	scientific	wikidata
jas.sagepub.com	scientific	wikidata
jasn.asnjournals.org	scientific	wikidata
jasss.soc.surrey.ac.uk	scientific	wikidata
jat.oxfordjournals.org	scientific	wikidata
jb.asm.org	scientific	wikidata
jb.oxfordjournals.org	scientific	wikidata
jb.ul.pt	scientific	wikidata
jba.sagepub.com	scientific	wikidata
jbc.org	scientific	wikidata
jbc.sagepub.com	scientific	wikidata
jbcs.sbq.org.br	scientific	wikidata
jbd.sagepub.com	scientific	wikidata
jbiol.com	scientific	wikidata
jbiomedsci.com	scientific	wikidata
jbiomedsem.com	scientific	wikidata
jbis.org.uk	scientific	wikidata
jbp.sagepub.com	scientific	wikidata
jbr.sagepub.com	scientific	wikidata
jbs.sagepub.com	scientific	wikidata
jbx.sagepub.com	scientific	wikidata
jca.sagepub.com	scientific	wikidata
jcasonline.com	scientific	wikidata
jcb.org	scientific	wikidata
jccjournal.org	scientific	wikidata
jcd.org.in	scientific	wikidata
jcd.sagepub.com	scientific	wikidata
jcda.ca	scientific	wikidata
jce.divched.org	scientific	wikidata
jce.sagepub.com	scientific	wikidata
jcea.agr.hr	scientific	wikidata
jcem.endojournals.org	scientific	wikidata
jcheminf.springeropen.com	scientific	wikidata
jci.org	scientific	wikidata
jcimjournal.com	scientific	wikidata
jcircadianrhythms.com	scientific	wikidata
jclinepi.com	scientific	wikidata
jcm.asm.org	scientific	wikidata
jcn.sagepub.com	scientific	wikidata
jco-online.com	scientific	wikidata
jco.org	scientific	wikidata
jcp.aip.org	scientific	wikidata
jcp.bmjjournals.com	scientific	wikidata
jcp.or.jp	news	wikidata
jcs.biologists.org	scientific	wikidata
jcs.mil	usgov	usgov
jcs.oxfordjournals.org	scientific	wikidata
jcs.sagepub.com	scientific	wikidata
jcsdonline.org	scientific	wikidata
jcx.sagepub.com	scientific	wikidata
jcytol.org	scientific	wikidata
jdm.sagepub.com	scientific	wikidata
jdnews.com	news	wikidata
jdr.sagepub.com	scientific	wikidata
jdsde.oxfordjournals.org	scientific	wikidata
jea.sagepub.com	scientific	wikidata
jeai.org	scientific	wikidata
jeb.biologists.org	scientific	wikidata
jeb.co.in	scientific	wikidata
jech.bmj.com	scientific	wikidata
jed.sagepub.com	scientific	wikidata
jee.org	scientific	wikidata
jeg.sagepub.com	scientific	wikidata
jei.sagepub.com	scientific	wikidata
jekyllrb.com	blog	wikidata
jel.sagepub.com	scientific	wikidata
jem.org	scientific	wikidata
jen.sagepub.com	scientific	wikidata
jenonline.org	scientific	wikidata
jep.sagepub.com	scientific	wikidata
jes.ecsdl.org	scientific	wikidata
jes.sagepub.com	scientific	wikidata
jet.arts.cornell.edu	scientific	wikidata
jetp.ac.ru	scientific	wikidata
jeune-independant.net	news	wikidata
jewsnews.co.il	fakenews	fakenewschecker
jezebel.com	fakenews	fakenewschecker
jfcom.mil	usgov	usgov
jfdaily.com	news	wikidata
jfe.rochester.edu	scientific	wikidata
jfe.sagepub.com	scientific	wikidata
jfh.sagepub.com	scientific	wikidata
jfi.sagepub.com	scientific	wikidata
jfm.sagepub.com	scientific	wikidata
jfmpc.gcal.ac.uk	scientific	wikidata
jfr.geoscienceworld.org	scientific	wikidata
jfr.unibo.it	scientific	wikidata
jfs.sagepub.com	scientific	wikidata
jfs.tku.edu.tw	scientific	wikidata
jfsc.ndu.edu	usgov	usgov
jgaa.info	scientific	wikidata
jgc301.com	scientific	wikidata
jgeosci.org	scientific	wikidata
jgid.org	scientific	wikidata
jgim.org	scientific	wikidata
jgm.sagepub.com	scientific	wikidata
jgp.rupress.org	scientific	wikidata
jgp.sagepub.com	scientific	wikidata
jgs.geoscienceworld.org	scientific	wikidata
jgv.sgmjournals.org	scientific	wikidata
jhc.sagepub.com	scientific	wikidata
jhcm.sagepub.com	scientific	wikidata
jhered.oxfordjournals.org	scientific	wikidata
jhetchem.com	scientific	wikidata
jhh.sagepub.com	scientific	wikidata
jhi.sagepub.com	scientific	wikidata
jhl.sagepub.com	scientific	wikidata
jhmas.oxfordjournals.org	scientific	wikidata
jhrsonline.org	scientific	wikidata
jhs.oxfordjournals.org	scientific	wikidata
jhs.sagepub.com	scientific	wikidata
jhv.sagepub.com	scientific	wikidata
jhypertension.com	scientific	wikidata
jia.sagepub.com	scientific	wikidata
jia.sipa.columbia.edu	scientific	wikidata
jiacam.org	scientific	wikidata
jiad.org	scientific	wikidata
jiaps.com	scientific	wikidata
jiasociety.org	scientific	wikidata
jibs.net	scientific	wikidata
jic.org.tw	scientific	wikidata
jic.sagepub.com	scientific	wikidata
jid.oxfordjournals.org	scientific	wikidata
jid.sagepub.com	scientific	wikidata
jidc.org	scientific	wikidata
jie.sagepub.com	scientific	wikidata
jim.sagepub.com	scientific	wikidata
jim.se	scientific	wikidata
jimdo.com	blog	handcoded
jimmunol.org	scientific	wikidata
jis.sagepub.com	scientific	wikidata
jisponline.com	scientific	wikidata
jisppd.com	scientific	wikidata
jit.sagepub.com	scientific	wikidata
jiv.sagepub.com	scientific	wikidata
jivresearch.org	scientific	wikidata
jjap.jsap.jp	scientific	wikidata
jjmie.hu.edu.jo	scientific	wikidata
jkas.kas.org	scientific	wikidata
jla.sagepub.com	scientific	wikidata
jleukbio.org	scientific	wikidata
jlo.sagepub.com	scientific	wikidata
jlr.org	scientific	wikidata
jls.sagepub.com	scientific	wikidata
jmcs.org.mx	scientific	wikidata
jme.bmj.com	scientific	wikidata
jme.endocrinology-journals.org	scientific	wikidata
jme.sagepub.com	scientific	wikidata
jmews.org	scientific	wikidata
jmg.bmj.com	scientific	wikidata
jmh.sagepub.com	scientific	wikidata
jmi.sagepub.com	scientific	wikidata
jmir.org	scientific	wikidata
jmk.sagepub.com	scientific	wikidata
jmlr.org	scientific	wikidata
jmm.sagepub.com	scientific	wikidata
jmm.sgmjournals.org	scientific	wikidata
jmmab.com	scientific	wikidata
jmo.sagepub.com	scientific	wikidata
jmp.org.in	scientific	wikidata
jmptonline.org	scientific	wikidata
jmq.sagepub.com	scientific	wikidata
jmt.dukejournals.org	scientific	wikidata
jmt.sagepub.com	scientific	wikidata
jn.nutrition.org	scientific	wikidata
jn.physiology.org	scientific	wikidata
jnccn.org	scientific	wikidata
jnci.oxfordjournals.org	scientific	wikidata
jneurodevdisorders.com	scientific	wikidata
jneuroinflammation.com	scientific	wikidata
jneurosci.org	scientific	wikidata
jni-journal.com	scientific	wikidata
jnm.snmjournals.org	scientific	wikidata
jnnp.bmj.com	scientific	wikidata
jnt.sagepub.com	scientific	wikidata
jobcorps.gov	usgov	usgov
jocg.org	scientific	wikidata
jod.sagepub.com	scientific	wikidata
joe.endocrinology-journals.org	scientific	wikidata
joeg.oxfordjournals.org	scientific	wikidata
joh.sagepub.com	scientific	wikidata
johnnyrobish.com	fakenews	fakenewschecker
joingoodbeing.com	commercial	handcoded
jom.sagepub.com	scientific	wikidata
jomfp.in	scientific	wikidata
joms.org	scientific	wikidata
jonesreport.com	clickbait|fakenews	fakenewschecker|handcoded
jonkopingsposten.se	news	wikidata
jonmd.com	scientific	wikidata
joomla.org	blog	wikidata
jop.ascopubs.org	scientific	wikidata
jopr.mpob.gov.my	scientific	wikidata
jornada.unam.mx	news	wikidata
jornaldeangola.sapo.ao	news	wikidata
jos.nu	scientific	wikidata
jos.oxfordjournals.org	scientific	wikidata
jos.sagepub.com	scientific	wikidata
jospt.org	scientific	wikidata
jou.sagepub.com	scientific	wikidata
journal-advocate.com	news	wikidata
journal-surgery.net	scientific	wikidata
journal.cpha.ca	scientific	wikidata
journal.frontiersin.org	scientific	wikidata
journal.georgetown.edu	scientific	wikidata
journal.r-project.org	scientific	wikidata
journalchiroed.com	scientific	wikidata
journaldemontreal.com	news	wikidata|handcoded
journalmtm.com	scientific	wikidata
journalnow.com	news	wikidata
journalofanimalecology.org	scientific	wikidata
journalofanimalscience.org	scientific	wikidata
journalofappliedecology.org	scientific	wikidata
journalofbehavioralfinance.org	scientific	wikidata
journalofcosmology.com	scientific	wikidata
journalofdemocracy.org	scientific	wikidata
journalofecology.org	scientific	wikidata
journalofelectronicpublishing.org	scientific	wikidata
journalofia.org	scientific	wikidata
journalofinfection.com	scientific	wikidata
journalofmas.com	scientific	wikidata
journalofnursingstudies.com	scientific	wikidata
journalofpaleontology.org	scientific	wikidata
journalofplay.org	scientific	wikidata
journalofrheology.org	scientific	wikidata
journalofsubstanceabusetreatment.com	scientific	wikidata
journalofsurgicalresearch.com	scientific	wikidata
journalofvision.org	scientific	wikidata
journalofwestafricanlanguages.org	scientific	wikidata
journalpioneer.com	news	wikidata
journals.ametsoc.org	scientific	wikidata
journals.aps.org	scientific	wikidata
journals.berghahnbooks.com	scientific	wikidata
journals.cambridge.org	scientific	wikidata
journals.co.za	scientific	wikidata
journals.elsevier.com	scientific	wikidata
journals.elsevierhealth.com	scientific	wikidata
journals.hil.unb.ca	scientific	wikidata
journals.humankinetics.com	scientific	wikidata
journals.impan.gov.pl	scientific	wikidata
journals.iucr.org	scientific	wikidata
journals.ju.edu.jo	scientific	wikidata
journals.ku.edu	scientific	wikidata
journals.lww.com	scientific	wikidata
journals.plos.org	scientific	wikidata
journals.rcni.com	scientific	wikidata
journals.sabinet.co.za	scientific	wikidata
journals.sfu.ca	scientific	wikidata
journals.sub.uni-hamburg.de	scientific	wikidata
journals.tubitak.gov.tr	scientific	wikidata
journals.tums.ac.ir	scientific	wikidata
journals.uchastings.edu	scientific	wikidata
journals.uchicago.edu	scientific	wikidata
journalsleep.org	scientific	wikidata
jove.com	scientific	wikidata
jp.physoc.org	scientific	wikidata
jpa.sagepub.com	scientific	wikidata
jpagonline.org	scientific	wikidata
jpalliativecare.com	scientific	wikidata
jpbsonline.org	scientific	wikidata
jpcrd.aip.org	scientific	wikidata
jpcs.iop.org	scientific	wikidata
jpe.sagepub.com	scientific	wikidata
jpeds.com	scientific	wikidata
jpeocbd.osd.mil	usgov	usgov
jpepsy.oxfordjournals.org	scientific	wikidata
jpet.aspetjournals.org	scientific	wikidata
jpf.sagepub.com	scientific	wikidata
jpgmonline.com	scientific	wikidata
jph.asu.edu	scientific	wikidata
jph.sagepub.com	scientific	wikidata
jpier.org	scientific	wikidata
jpma.org.pk	scientific	wikidata
jpml.uscourts.gov	usgov	usgov
jpo.sagepub.com	scientific	wikidata
jpost.com	news	wikidata
jpp.sagepub.com	scientific	wikidata
jpr.sagepub.com	scientific	wikidata
jpsj.ipap.jp	scientific	wikidata
jpsmjournal.com	scientific	wikidata
jpssm.org	scientific	wikidata
jpubhealth.oxfordjournals.org	scientific	wikidata
jra.sagepub.com	scientific	wikidata
jrc.sagepub.com	scientific	wikidata
jrheum.org	scientific	wikidata
jrm.sagepub.com	scientific	wikidata
jrn.sagepub.com	scientific	wikidata
jrp.icaap.org	scientific	wikidata
jrse.aip.org	scientific	wikidata
jsa.revues.org	scientific	wikidata
jsad.com	scientific	wikidata
jsantisemitism.org	scientific	wikidata
jsbba.or.jp	scientific	wikidata
jsd.sagepub.com	scientific	wikidata
jse.sagepub.com	scientific	wikidata
jsi.sagepub.com	scientific	wikidata
jsis.washington.edu	scientific	wikidata
jsite.uwm.edu.pl	scientific	wikidata
jsm.sagepub.com	scientific	wikidata
jsn.sagepub.com	scientific	wikidata
jsonline.com	news	wikidata
jsp.sagepub.com	scientific	wikidata
jspsciences.org	scientific	wikidata
jsr.sagepub.com	scientific	wikidata
jss.sagepub.com	scientific	wikidata
jstage.jst.go.jp	scientific	wikidata
jstatsoft.org	scientific	wikidata
jstor.org	scientific	wikidata
jsw.arizona.edu	scientific	wikidata
jsw.sagepub.com	scientific	wikidata
jtc.sagepub.com	scientific	wikidata
jtd.sagepub.com	scientific	wikidata
jte.sagepub.com	scientific	wikidata
jth.sagepub.com	scientific	wikidata
jtlu.org	scientific	wikidata
jtopol.oxfordjournals.org	scientific	wikidata
jubilat.org	scientific	wikidata
jucs.org	scientific	wikidata
juh.sagepub.com	scientific	wikidata
jules-verne.net	scientific	wikidata
juneauempire.com	news	wikidata
jungewelt.de	news	wikidata
jurology.com	scientific	wikidata
jusfc.gov	usgov	usgov
justice.gov	usgov	usgov
justsecurity.org	blog	handcoded
juvenilecouncil.gov	usgov	usgov
juventudrebelde.cu	news	wikidata
jvc.sagepub.com	scientific	wikidata
jvdi.sagepub.com	scientific	wikidata
jvi.asm.org	scientific	wikidata
jwildlifedis.org	scientific	wikidata
jwsr.org	scientific	wikidata
jxb.oxfordjournals.org	scientific	wikidata
k-state.edu	scientific	wikidata
kahoku.co.jp	news	wikidata
kainuunsanomat.fi	news	wikidata
kaleva.fi	news	wikidata
kansas.gov	usgov	usgov
kansasacademyscience.org	scientific	wikidata
kansascity.com	news	wikidata
karger.com	scientific	wikidata
karjalainen.fi	news	wikidata
kathmandupost.ekantipur.com	news	wikidata
kaunodiena.lt	news	wikidata
kayhan.ir	news	wikidata
kelownadailycourier.ca	news	wikidata
kennedy-center.org	usgov	usgov
kenoradailyminerandnews.com	news	wikidata
kentico.com	blog	wikidata
kentucky.gov	usgov	usgov
kentuckygov.desk.com	usgov	usgov
kentuckytourism.com	usgov	usgov
kenyonreview.org	scientific	wikidata
kernos.ulg.ac.be	scientific	wikidata
kerux.com	scientific	wikidata
keskipohjanmaa.net	news	wikidata
ketchikandailynews.com	news	wikidata
khabaristantimes.com	fakenews	handcoded
khan.co.kr	news	wikidata
khn.org	news	handcoded
kidb.org	scientific	wikidata
kiej.georgetown.edu	scientific	wikidata
killscreendaily.com	news	handcoded
kiltr.com	socialmedia	wikidata
kingmandailyminer.com	news	wikidata
kingworldnews.com	fakenews	fakenewschecker
kinja.com	blog	wikidata
kirj.ee	scientific	wikidata
kitsapsun.com	news	wikidata
kjs.re.kr	scientific	wikidata
kkk.com	fakenews	fakenewschecker
klemens.sav.sk	scientific	wikidata
kluwerlawonline.com	scientific	wikidata
kluweronline.com	scientific	wikidata
knowyouroptions.com	usgov	usgov
knoxnews.com	news	wikidata
kodiakdailymirror.com	news	wikidata
koedoe.co.za	scientific	wikidata
kommersant.ru	news	wikidata
koreascience.or.kr	scientific	wikidata
kosmos.icm.edu.pl	scientific	wikidata
kp.ru	news	wikidata
krisis.eu	scientific	wikidata
kristianstadsbladet.se	news	wikidata
kritike.org	scientific	wikidata
kronika.ro	news	wikidata
kslottery.com	usgov	usgov
ksml.fi	news	wikidata
ksrevenue.org	usgov	usgov
kssos.org	usgov	usgov
ksta.de	news	wikidata
ktpress.co.uk	scientific	wikidata
kyklos-review.ch	scientific	wikidata
kylottery.com	usgov	usgov
kymensanomat.fi	news	wikidata
kypost.com	news	wikidata
l-actu.fr	news	wikidata
l-iz.de	news	wikidata
la-croix.com	news	wikidata
la-press.com	scientific	wikidata
lacote.ch	news	wikidata
lacrocequotidiano.it	news	wikidata
lacrossetribune.com	news	wikidata
lactualitechimique.org	scientific	wikidata
ladepeche.pf	news	wikidata
ladiscussione.com	news	wikidata
lagazzettadelmezzogiorno.it	news	wikidata
laineygossip.com	news	handcoded
lakartidningen.se	scientific	wikidata
laliberte.ch	news	wikidata
lalibre.be	news	wikidata
lamontagne.fr	news	wikidata
lanacion.cl	news	wikidata
lanacion.com	news	wikidata
lancenet.com.br	news	wikidata
landbote.ch	news	wikidata
landesbioscience.com	scientific	wikidata
landesmuseum.ktn.gv.at	scientific	wikidata
landoverbaptist.org	fakenews	handcoded
landscaperesearch.livingreviews.org	scientific	wikidata
langtech.dickinson.edu	scientific	wikidata
languageacquisition.org	scientific	wikidata
lankadeepa.lk	news	wikidata
lanotizia.ch	news	wikidata
lansi-savo.fi	news	wikidata
lanuovaferrara.gelocal.it	news	wikidata
lapinkansa.fi	news	wikidata
laprensa.com.ar	news	wikidata
lapresse.ca	news	wikidata
laprovence.com	news	wikidata
laprovincia.it	news	wikidata
laprovinciadicremona.it	news	wikidata
laprovinciadivarese.it	news	wikidata
laprovinciapavese.repubblica.it	news	wikidata
larazon.com.ar	news	wikidata
larazon.es	news	wikidata
larecherche.fr	scientific	wikidata
laregione.ch	news	wikidata
larena.it	news	wikidata
larep.fr	news	wikidata
larepublica.co	news	wikidata
larouchepub.com	fakenews	fakenewschecker
larsg.fr	scientific	wikidata
las.sagepub.com	scientific	wikidata
lasa.international.pitt.edu	scientific	wikidata
laserfocusworld.com	scientific	wikidata
laskyaesthetics.com	commercial	handcoded
lasphys.com	scientific	wikidata
lasprovincias.es	news	wikidata
last.fm	socialmedia	wikidata
lastampa.it	news	wikidata
latempete.info	news	wikidata
latercera.com	news	wikidata
latimes.com	news	wikidata|handcoded
latinamericanperspectives.com	scientific	wikidata
latribune-online.com	news	wikidata
lavoixdunord.fr	news	wikidata
lavozdeasturias.es	news	wikidata
lavozdegalicia.es	news	wikidata
law.tau.ac.il	scientific	wikidata
law.umich.edu	scientific	wikidata
lawfareblog.com	blog	handcoded
lcweb.loc.gov	usgov	usgov
ldx.sagepub.com	scientific	wikidata
le-petitbleu.fr	news	wikidata
le.ac.uk	scientific	wikidata
le10sport.com	news	wikidata
lea.sagepub.com	scientific	wikidata
leaderpost.com	news	wikidata|handcoded
learnerblogs.org	blog	handcoded
lec.sagepub.com	scientific	wikidata
lecho.be	news	wikidata
leconomiepolitique.fr	scientific	wikidata
leconomiste.com	news	wikidata
lecourrier.ch	news	wikidata
lecourrier.vn	news	wikidata
ledauphine.com	news	wikidata
leeds.ac.uk	scientific	wikidata
lefigaro.fr	news	wikidata
lefigaropatrimoine.fr	news	wikidata
lefinancier-dz.com	news	wikidata
legacywomenwriters.org	scientific	wikidata
leggo.it	news	wikidata
legislative.noaa.gov	usgov	usgov
legorafi.fr	fakenews	handcoded
leibnizreview.com	scientific	wikidata
leicestermercury.co.uk	news	wikidata
lejpb.com	news	wikidata
lematin.ch	news	wikidata
lematin.ma	news	wikidata
lematindz.net	news	wikidata
lematinhaiti.com	news	wikidata
lemauricien.com	news	wikidata
lemonde.fr	news	wikidata
lemouvementsocial.net	scientific	wikidata
lentomologiste.fr	scientific	wikidata
leo.cineca.it	scientific	wikidata
leonardo.info	scientific	wikidata
lep.co.uk	news	wikidata
leparisien.fr	news	wikidata
lepetitquotidien.fr	news	wikidata
lephareonline.net	news	wikidata
lepotentielonline.com	news	wikidata
leprogres.fr	news	wikidata
lequotidien-oran.com	news	wikidata
lequotidien.re	news	wikidata
lequotidien.sn	news	wikidata
lequotidien.tn	news	wikidata
ler.letras.up.pt	scientific	wikidata
lerenouveau.com.tn	news	wikidata
lesauvage.org	news	wikidata
lesdebats.com	news	wikidata
lesdepechesdebrazzaville.fr	news	wikidata
lesechos.ml	news	wikidata
lesoftonline.net	news	wikidata
lesoirdalgerie.com	news	wikidata
lesoleil.sn	news	wikidata
lessentiel.lu	news	wikidata
letelegramme.com	news	wikidata
letemps.ch	news	wikidata
letemps.com.tn	news	wikidata
letempsdz.com	news	wikidata
lethbridgeherald.com	news	wikidata
levante-emv.com	news	wikidata
leveil.fr	news	wikidata
lewrockwell.com	clickbait|fakenews	fakenewschecker|handcoded
lexblog.com	news	handcoded
lexikos.journals.ac.za	scientific	wikidata
lexpress.ch	news	wikidata
lexpress.mu	news	wikidata
lexpressiondz.com	news	wikidata
lfpress.com	news	wikidata
lhomme.revues.org	scientific	wikidata
lib.slu.edu	scientific	wikidata
lib.unb.ca	scientific	wikidata
libe.ma	news	wikidata
liberalamerica.org	fakenews	fakenewschecker|handcoded
liberaldarkness.com	fakenews	fakenewschecker
liberalquotidiano.it	news	wikidata
liberation-champagne.fr	news	wikidata
liberation.fr	news	wikidata
liberazione.it	news	wikidata
liberoquotidiano.it	news	wikidata
liberta.it	news	wikidata
liberte-algerie.com	news	wikidata
libertyaction.org	commercial	handcoded
libertyblitzkrieg.com	fakenews	fakenewschecker
libertymovementradio.com	clickbait|fakenews	fakenewschecker|handcoded
libertynews.com	fakenews	fakenewschecker
libertytalk.fm	clickbait|fakenews	handcoded
libertyunyielding.com	fakenews	fakenewschecker|handcoded
libertyvideos.com	fakenews	fakenewschecker
libertyvideos.org	clickbait|fakenews	handcoded
libertywritersnews.com	fakenews	fakenewschecker
libraries.slu.edu	scientific	wikidata
library.seg.org	scientific	wikidata
libraweb.net	scientific	wikidata
libre.inquirer.net	news	wikidata
libreas.eu	scientific	wikidata
lidovky.cz	news	wikidata
liebertpub.com	scientific	wikidata
lifehacker.com	news	handcoded
lifetype.net	blog	wikidata
lifezette.com	fakenews	fakenewschecker
liftable.com	fakenews	fakenewschecker
lilt.ilstu.edu	scientific	wikidata
limpartial.ch	news	wikidata
lin.sagepub.com	scientific	wikidata
lineaquotidiano.net	news	wikidata
linformazione.com	news	wikidata
linguistic-typology.org	scientific	wikidata
linguisticsociety.org	scientific	wikidata
lingv.ro	scientific	wikidata
link.springer.com	scientific	wikidata
linkagoal.com	socialmedia	wikidata
linkedin.com	socialmedia	wikidata|handcoded
lis.sagepub.com	scientific	wikidata
lituanus.org	scientific	wikidata
live.com	blog	handcoded
livejournal.com	blog|socialmedia	wikidata|handcoded
liveleak.com	videos	wikidata
livemint.com	news	handcoded
livescience.com	news	handcoded
livestream.com	videos	wikidata
lkcnhm.nus.edu.sg	scientific	wikidata
llgc.org.uk	scientific	wikidata
lmcs-online.org	scientific	wikidata
lmr.	fakenews	handcoded
ln-medienhaus.de	news	wikidata
lnr-dz.com	news	wikidata
lobservateur.bf	news	wikidata
lobservateur.cd	news	wikidata
lobservateur.sn	news	wikidata
loc.gov	usgov	usgov
locator.ice.gov	usgov	usgov
logcom.oxfordjournals.org	scientific	wikidata
logika.uwb.edu.pl	scientific	wikidata
lohud.com	news	wikidata
lokprashna.com	news	wikidata
longriverreview.com	scientific	wikidata
lopinion.fr	news	wikidata
lorientlejour.com	news	wikidata
losgatosdailynews.com	news	wikidata
lottery.az.gov	usgov	usgov
lottery.nd.gov	usgov	usgov
lottery.ok.gov	usgov	usgov
lottery.sd.gov	usgov	usgov
lotteryusa.com	usgov	usgov
loudblog.com	blog	wikidata
louisiana.gov	usgov	usgov
louisianalottery.com	usgov	usgov
louisianatravel.com	usgov	usgov
lpl.arizona.edu	scientific	wikidata
lpr-journal.org	scientific	wikidata
lqj.ch	news	wikidata
lrjournal.com	scientific	wikidata
lrt.sagepub.com	scientific	wikidata
lsc.gov	usgov	usgov
lse.ma	news	wikidata
ltj.sagepub.com	scientific	wikidata
ltr.sagepub.com	scientific	wikidata
lucas.leeds.ac.uk	scientific	wikidata
lungindia.com	scientific	wikidata
lup.sagepub.com	scientific	wikidata
lushforlife.com	fakenews	fakenewschecker|handcoded
luventicus.org	scientific	wikidata
lux-post.lu	news	wikidata
lwbooks.co.uk	scientific	wikidata
lww.com	scientific	handcoded
lyceum.ibiblio.org	blog	wikidata
lyonne-republicaine.fr	news	wikidata
maa.org	scientific	wikidata
maalaimalar.com	news	wikidata
maariv.co.il	news	wikidata
mabelsaveforschool.com	commercial	handcoded
macejournal.org	scientific	wikidata
macleans.ca	news	handcoded
macn.secyt.gov.ar	scientific	wikidata
macpac.gov	usgov	usgov
macworld.com	news	handcoded
madebyfrog.com	blog	wikidata
madworldnews.com	fakenews	fakenewschecker
magazine.ieee-pes.org	scientific	wikidata
magazineforhealthy.com	blog	handcoded
magazinemieuxetre.com	scientific	wikidata
magic.pennpress.org	scientific	wikidata
magicvalley.com	news	wikidata
maik.rssi.ru	scientific	wikidata
maik.ru	scientific	wikidata
mail.house.gov	usgov	usgov
mail.nih.gov	usgov	usgov
maine.gov	usgov	usgov
mainelottery.com	usgov	usgov
mainichi.co.jp	news	wikidata
makeamericagreattoday.com	fakenews	fakenewschecker
malariajournal.com	scientific	wikidata
manchestereveningnews.co.uk	news	wikidata
manchesteruniversitypress.co.uk	scientific	wikidata
mandestudies.org	scientific	wikidata
maney.co.uk	scientific	wikidata
maneyonline.com	scientific	wikidata
maneypublishing.com	scientific	wikidata
mankindquarterly.com	scientific	wikidata
manoajournal.hawaii.edu	scientific	wikidata
manoramaonline.com	news	wikidata
mapress.com	scientific	wikidata
marad.dot.gov	usgov	usgov
march-against-monsanto.com	blog	handcoded
marineornithology.org	scientific	wikidata
marineresourceeconomics.com	scientific	wikidata
marinersoftware.com	blog	wikidata
marines.com	usgov	usgov
marines.mil	usgov	usgov
marketing-mba.ru	scientific	wikidata
marquette.edu	scientific	wikidata
maryland.gov	usgov	usgov
mashable.com	news	handcoded
mass.gov	usgov	usgov
masslottery.com	usgov	usgov
massreview.org	scientific	wikidata
massrmv.com	usgov	usgov
materialstoday.com	scientific	wikidata
materiologiques.com	scientific	wikidata
math.nthu.edu.tw	scientific	wikidata
math.vanderbilt.edu	scientific	wikidata
mathnet.ru	scientific	wikidata
mathpsych.org	scientific	wikidata
maturitas.org	scientific	wikidata
mayoclinic.org	news	handcoded
mayoclinicproceedings.org	scientific	wikidata|handcoded
mayor.dc.gov	usgov	usgov
maz-online.de	news	wikidata
mba.ac.uk	scientific	wikidata
mbajournal.kozminski.edu.pl	scientific	wikidata
mbda.gov	usgov	usgov
mbe.oxfordjournals.org	scientific	wikidata
mbio.asm.org	scientific	wikidata
mbl.is	news	wikidata
mbs-journal.de	scientific	wikidata
mcb.asm.org	scientific	wikidata
mcc.gov	usgov	usgov
mcponline.org	scientific	wikidata
mcq.sagepub.com	scientific	wikidata
mcr.sagepub.com	scientific	wikidata
mcser.org	scientific	wikidata
mcv.revues.org	scientific	wikidata
mcx.sagepub.com	scientific	wikidata
mda.mil	usgov	usgov
mdb.cast.ru	scientific	wikidata
mdlottery.com	usgov	usgov
mdm.sagepub.com	scientific	wikidata
mdoc.state.ms.us	usgov	usgov
mdpi.com	scientific	wikidata|handcoded
mdt.mt.gov	usgov	usgov
me2day.net	socialmedia	wikidata
meajo.org	scientific	wikidata
mec.sagepub.com	scientific	wikidata
mechademia.org	scientific	wikidata
medecinesciences.org	scientific	wikidata
mediamass.net	fakenews	handcoded
mediamatinquebec.com	news	wikidata
mediamatters.org	fakenews	fakenewschecker
medicaid.gov	usgov	usgov
medicaldaily.com	blog	handcoded
medicalimaging.spiedigitallibrary.org	scientific	wikidata
medicalnewstoday.com	news	handcoded
medicine.yale.edu	scientific	wikidata
medicinehatnews.com	news	wikidata
medievales.revues.org	scientific	wikidata
medium.com	blog	wikidata|handcoded
mednet.nl	scientific	wikidata
medpac.gov	usgov	usgov
medpagetoday.com	news	handcoded
medphys.org	scientific	wikidata
medscape.com	news	handcoded
medsci.org	scientific	wikidata
medscimonit.com	scientific	wikidata
megynkelly.us	clickbait|fakenews	handcoded
mei.edu	scientific	wikidata
mej.sagepub.com	scientific	wikidata
melanienini.net	commercial	handcoded
mend.endojournals.org	scientific	wikidata
menshealth.com	news	handcoded
mensstudies.info	scientific	wikidata
mentelocale.it	news	wikidata
mequarterly.org	scientific	wikidata
mercola.com	fakenews	handcoded
mercurynews.com	news	wikidata
merip.org	scientific	wikidata
mesharpe.com	scientific	wikidata
mesharpe.metapress.com	scientific	wikidata
messaggeroveneto.it	news	wikidata
meteoriticalsociety.org	scientific	wikidata
methodsinecologyandevolution.org	scientific	wikidata
metro.co.uk	news	wikidata
metro.lu	news	wikidata
metrohk.com.hk	news	wikidata
metroland.com	news	handcoded
metropolisweb.it	news	wikidata
mfdnes.cz	news	wikidata
mhd.sal.lv	scientific	wikidata
mhj.net.au	scientific	wikidata
mhra.org.uk	scientific	wikidata
mhsi.ie	scientific	wikidata
miamiherald.com	news	wikidata
mic.sgmjournals.org	scientific	wikidata
michigan.gov	usgov	usgov
michigan.org	usgov	usgov
michiganjb.org	scientific	wikidata
michiganlottery.com	usgov	usgov
michiganquarterlyreview.com	scientific	wikidata
mid-day.com	news	wikidata|handcoded
midgard-project.org	blog	wikidata
midilibre.fr	news	wikidata
mie.sagepub.com	scientific	wikidata
migrationletters.com	scientific	wikidata
miitomo.com	socialmedia	wikidata
miiz.waw.pl	scientific	wikidata
mikroglottika.com	scientific	wikidata
milenio.com	news	wikidata
militaryinstallations.dod.mil	usgov	usgov
militarytimes.com	blog	handcoded
militianews.com	fakenews	fakenewschecker
mind.oxfordjournals.org	scientific	wikidata
mineralogicalassociation.ca	scientific	wikidata
minervamedica.it	scientific	wikidata
mingaonline.uach.cl	scientific	wikidata
mingpaotor.com	news	wikidata
minius.webs.uvigo.es	scientific	wikidata
minorityhealth.hhs.gov	usgov	usgov
minorplanet.info	scientific	wikidata
minrec.org	scientific	wikidata
minsocam.org	scientific	wikidata
mirror.co.uk	news|fakenews	fakenewschecker|wikidata
mis.sagepub.com	scientific	wikidata
mises.org	scientific	wikidata
misq.org	scientific	wikidata
mississippi.gov	usgov	usgov
mississippilotteryresults.org	usgov	usgov
missourireview.com	scientific	wikidata
mitpress.mit.edu	scientific	wikidata
mitpressjournals.org	scientific	wikidata
mja.com.au	scientific	wikidata
mjtimes.sk.ca	news	wikidata
ml.oxfordjournals.org	scientific	wikidata
mlive.com	news	wikidata
mlj.miis.edu	scientific	wikidata
mlq.dukejournals.org	scientific	wikidata
mlq.sagepub.com	scientific	wikidata
mmbr.asm.org	scientific	wikidata
mmc.gov	usgov	usgov
mmd.sagepub.com	scientific	wikidata
mmj.sagepub.com	scientific	wikidata
mmr.sagepub.com	scientific	wikidata
mms.sagepub.com	scientific	wikidata
mmvc.ms.gov	usgov	usgov
mn.gov	usgov	usgov
mnlottery.com	usgov	usgov
mnras.oxfordjournals.org	scientific	wikidata
mns.org.my	scientific	wikidata
mnvotesinfo.sos.state.mn.us	usgov	usgov
mo.gov	usgov	usgov
mobile.nytimes.com	news	handcoded
mobile.reuters.com	news	handcoded
mobilesyrup.com	news	handcoded
mobot.org	scientific	wikidata
mocospace.com	socialmedia	wikidata
modernhealthcare.com	news	handcoded
moh.sagepub.com	scientific	wikidata
mohr.de	scientific	wikidata
moihelsinki.com	socialmedia	wikidata
moikrug.ru	socialmedia	wikidata
molbiolcell.org	scientific	wikidata
molecbio.com	scientific	wikidata
molecularautism.com	scientific	wikidata
molecularbrain.com	scientific	wikidata
molecularneurodegeneration.com	scientific	wikidata
molecularpain.com	scientific	wikidata
mollus.nl	scientific	wikidata
mollus.oxfordjournals.org	scientific	wikidata
molmed.org	scientific	wikidata
moloncol.org	scientific	wikidata
molottery.com	usgov	usgov
molpharm.aspetjournals.org	scientific	wikidata
molvis.org	scientific	wikidata
monacomatin.mc	news	wikidata
money.cnn.com	news	handcoded
moneyfactory.gov	usgov	usgov
monist.buffalo.edu	scientific	wikidata
montanalottery.com	usgov	usgov
montgomeryadvertiser.com	news	wikidata
monthlyreview.org	scientific	wikidata
montrealgazette.com	news	wikidata
monumenta.cc.sophia.ac.jp	scientific	wikidata
moonofalabama.org	fakenews	fakenewschecker
morgenpost.de	news	wikidata
morningledger.com	fakenews	fakenewschecker
morningstaronline.co.uk	news	wikidata
motherboard.vice.com	news	handcoded
motherjones.com	fakenews	fakenewschecker
mountaineagle.com	news	wikidata
movabletype.org	blog	wikidata
movim.eu	blog	wikidata
mpidailymagazine.com	fakenews	fakenewschecker
mplant.oxfordjournals.org	scientific	wikidata
mptmagazine.com	scientific	wikidata
mrconservative.com	fakenews	fakenewschecker
mrt.com	news	wikidata
msa.press.jhu.edu	scientific	wikidata
msegov.com	usgov	usgov
msforum.net	scientific	wikidata
msha.gov	usgov	usgov
msmonographs.org	scientific	wikidata
msn.com	blog	handcoded
msnbc.co	fakenews	handcoded
msnbc.com	news	handcoded
msnbc.com.co	fakenews	handcoded
msnbc.website	fakenews	handcoded
msp.org	scientific	wikidata
msp.warwick.ac.uk	scientific	wikidata
mspb.gov	usgov	usgov
mss.sagepub.com	scientific	wikidata
msupress.msu.edu	scientific	wikidata
msx.sagepub.com	scientific	wikidata
mt.gov	usgov	usgov
mtjournal.ru	scientific	wikidata
mtp.hum.ku.dk	scientific	wikidata
mtq.sagepub.com	scientific	wikidata
mtt.org	scientific	wikidata
mtv.com	news	handcoded
muehlacker-tagblatt.de	news	wikidata
multi-science.co.uk	scientific	wikidata
multiply.com	blog	handcoded
mundodeportivo.com	news	wikidata
muse.jhu.edu	scientific	wikidata
museumoftheearth.org	scientific	wikidata
museumvictoria.com.au	scientific	wikidata
museuprehistoriavalencia.es	scientific	wikidata
musiccanada.com	news	handcoded
musiclibraryassoc.org	scientific	wikidata
mutations-online.info	news	wikidata
mva.maryland.gov	usgov	usgov
mvd.newmexico.gov	usgov	usgov
mvd.usace.army.mil	usgov	usgov
mwc.sagepub.com	scientific	wikidata
mx.net.au	news	wikidata
my.mail.ru	socialmedia	wikidata
myarkansaslottery.com	usgov	usgov
mycokeys.pensoft.net	scientific	wikidata
mycologia.org	scientific	wikidata
mycotaxon.com	scientific	wikidata
myemail.constantcontact.com	commercial	handcoded
myflorida.com	usgov	usgov
mymarianas.com	usgov	usgov
myrmecologicalnews.org	scientific	wikidata
myspace.com	socialmedia	wikidata
mythsoc.org	scientific	wikidata
myzonetoday.com	fakenews	fakenewschecker
na.se	news	wikidata
nacion.com	news	wikidata
naftemporiki.gr	news	wikidata
nah.sagepub.com	scientific	wikidata
nahadaily.com	satire|fakenews	handcoded
naika.or.jp	scientific	wikidata
najms.org	scientific	handcoded
nanolabweb.com	scientific	wikidata
nanolithography.spiedigitallibrary.org	scientific	wikidata
nanophotonics.spiedigitallibrary.org	scientific	wikidata
napavalleyregister.com	news	wikidata
nar.oxfordjournals.org	scientific	wikidata
nara.gov	usgov	usgov
narrowgaugeandindustrial.co.uk	scientific	wikidata
nas.sagepub.com	scientific	wikidata
nasa.gov	usgov|news	usgov|handcoded
nashvillecitypaper.com	news	wikidata
nasponline.org	scientific	wikidata
nass.oxfordjournals.org	scientific	wikidata
nass.usda.gov	usgov	usgov
nationaalherbarium.nl	scientific	wikidata
nationalgeographic.com	news	handcoded
nationalguard.com	usgov	usgov
nationalguard.mil	usgov	usgov
nationalinsiderpolitics.com	fakenews	fakenewschecker
nationaljournal.com	news	handcoded
nationalparks.org	usgov	usgov
nationalpost.com	news	handcoded
nationalreport.net	fakenews	fakenewschecker|handcoded
nationalreview.com	news	handcoded
nationalservice.gov	usgov	usgov
nationmultimedia.com	news	wikidata
nationofchange.org	fakenews	fakenewschecker
nationonenews.com	fakenews	fakenewschecker
nats.org	scientific	wikidata
naturalhealth365.com	blog	handcoded
naturalhistorymag.com	scientific	wikidata
naturalnews.com	clickbait|fakenews	handcoded
nature.com	news|scientific	wikidata|handcoded
naturebase.net	scientific	wikidata
naugatuckriverreview.com	scientific	wikidata
nautil.us	news	handcoded
navy.com	usgov	usgov
navy.mil	usgov	usgov
nbc-news.net	fakenews	handcoded
nbc.com.co	fakenews	handcoded
nbc.gov	usgov	usgov
nbcnews.com	news	handcoded
nbn-resolving.de	news|scientific	wikidata
nc-educationlottery.org	usgov	usgov
nc.gov	usgov	usgov
ncbi.nlm.nih.gov	scientific	wikidata|handcoded
nccdb.fmcsa.dot.gov	usgov	usgov
ncd.gov	usgov	usgov
ncdot.gov	usgov	usgov
ncdps.gov	usgov	usgov
ncfs-journal.org	scientific	wikidata
ncix.gov	usgov	usgov
ncjrs.gov	usgov	usgov
ncp.sagepub.com	scientific	wikidata
ncpc.gov	usgov	usgov
ncra.tifr.res.in	scientific	wikidata
ncsbe.gov	usgov	usgov
ncsc.gov	usgov	usgov
ncscooper.com	fakenews	handcoded
ncsu.edu	scientific	wikidata
nct.com	fakenews	handcoded
ncte.org	scientific	wikidata
nctm.org	scientific	wikidata
ncua.gov	usgov	usgov
nd.edu	scientific	wikidata
nd.gov	usgov	usgov
ndquarterly.org	scientific	wikidata
ndreview.nd.edu	scientific	wikidata
ndrmag.org	scientific	wikidata
ndt.oxfordjournals.org	scientific	wikidata
ndtourism.com	usgov	usgov
ndu.edu	usgov	usgov
ne.doe.gov	usgov	usgov
nebraska.gov	usgov	usgov
nebraskapress.unl.edu	scientific	wikidata
neh.gov	usgov	usgov
neilsonjournals.com	scientific	wikidata
nej.sagepub.com	scientific	wikidata
nejm.org	scientific	wikidata|handcoded
nelottery.com	usgov	usgov
neoaristotelica.eu	scientific	wikidata
neotropicalbirdclub.org	scientific	wikidata
nepjoph.org.np	scientific	wikidata
nepszava.hu	news	wikidata
nereview.com	scientific	wikidata
neues-deutschland.de	news	wikidata
neurology.org	scientific	wikidata|handcoded
neurologyindia.com	scientific	wikidata
neuron.org	scientific	wikidata
neurophotonics.spiedigitallibrary.org	scientific	wikidata
neuroquantology.com	scientific	wikidata
neuroreport.com	scientific	wikidata
neurosurgery-online.com	scientific	wikidata
nevadadot.com	usgov	usgov
nevadalotteryresults.org	usgov	usgov
newcenturytimes.com	fakenews	fakenewschecker|handcoded
newelectronics.co.uk	scientific	wikidata
newformations.co.uk	scientific	wikidata
newhavenreview.com	scientific	wikidata
newizv.ru	news	wikidata
newjournal.kcsnet.or.kr	scientific	wikidata
newletters.org	scientific	wikidata
newmedia-dz.com	news	wikidata
newmexico.gov	usgov	usgov
newmexico.org	usgov	usgov
neworleansreview.org	scientific	wikidata
newrepublic.com	news	handcoded
news-hound.com	fakenews	handcoded
news-journalonline.com	news	wikidata
news.anotao.com	blog	handcoded
news.com.au	news	wikidata
news.gc.ca	news	handcoded
news.mingpao.com	news	wikidata
news.vice.com	news	handcoded
news4ktla.com	fakenews	fakenewschecker
newsbiscuit.com	fakenews	fakenewschecker|handcoded
newsbreakers.org	fakenews	fakenewschecker
newsbusters.org	fakenews	fakenewschecker
newschief.com	news	wikidata
newschool.edu	scientific	wikidata
newscientist.com	news|scientific	wikidata|handcoded
newscorpse.com	fakenews	fakenewschecker
newsday.com	news	wikidata
newsexaminer.com	fakenews	handcoded
newsherald.com	news	wikidata
newslo.com	satire|fakenews	handcoded
newsmax.com	news	handcoded
newsminer.com	news	wikidata
newsmutiny.com	fakenews	fakenewschecker|handcoded
newstarget.com	fakenews	fakenewschecker
newsthump.com	fakenews	fakenewschecker
newswatch28.com	fakenews	handcoded
newswatch33.com	fakenews	handcoded
newsweek.com	news	handcoded
newswire-24.com	clickbait|fakenews	fakenewschecker|handcoded
newswithviews.com	fakenews	fakenewschecker
newyorker.com	news	handcoded
nflrc.hawaii.edu	scientific	wikidata
ng.army.mil	usgov	usgov
nga.gov	usgov	usgov
nga.mil	usgov	usgov
ngnews.ca	news	wikidata
nh.gov	usgov	usgov
nhic.org	usgov	usgov
nhl.com	news	handcoded
nhlottery.com	usgov	usgov
nhm.ac.uk	scientific	wikidata
nhm.uio.no	scientific	wikidata
nhtsa.dot.gov	usgov	usgov
nhtsa.gov	usgov	usgov
ni-u.edu	usgov	usgov
niams.nih.gov	usgov	usgov
nicematin.fr	news	wikidata
nicic.gov	usgov	usgov
niesr.ac.uk	scientific	wikidata
nieuwsblad.be	news	wikidata
nifa.usda.gov	usgov	usgov
nifc.gov	usgov	usgov
nigc.gov	usgov	usgov
nih.gov	usgov|scientific	usgov|handcoded
nij.gov	usgov	usgov
nikkei.com	news	wikidata
nimh.nih.gov	usgov	usgov
ning.com	blog|socialmedia	wikidata|handcoded
ninthletter.com	scientific	wikidata
nippur.irb.hr	scientific	wikidata
nirc.nanzan-u.ac.jp	scientific	wikidata
nisc.co.za	scientific	wikidata
nishinippon.co.jp	news	wikidata
nist.gov	usgov	usgov
nj.com	news	wikidata
nj.gov	usgov	usgov
njas.helsinki.fi	scientific	wikidata
njelections.org	usgov	usgov
njlottery.com	usgov	usgov
nk.pl	socialmedia	wikidata
nlai.ir	scientific	wikidata
nlm.nih.gov	usgov	usgov
nlrb.gov	usgov	usgov
nmag.gov	usgov	usgov
nmb.gov	usgov	usgov
nmfs.noaa.gov	usgov	usgov
nmji.in	scientific	wikidata
nmlottery.com	usgov	usgov
nms.sagepub.com	scientific	wikidata
nnn.co.jp	news	wikidata
nnsa.doe.gov	usgov	usgov
nnsa.energy.gov	usgov	usgov
noaa.gov	usgov	usgov
nodisinfo.com	clickbait|fakenews	fakenewschecker|handcoded
noesis.evansville.edu	scientific	wikidata
nof.econ.ku.dk	scientific	wikidata
noiseandhealth.org	scientific	wikidata
nol.hu	news	wikidata
nola.com	news	wikidata
nopr.niscair.res.in	scientific	wikidata
nor-miltids.com	scientific	wikidata
nordbayern.de	news	wikidata
nordeclair.fr	news	wikidata
norois.revues.org	scientific	wikidata
northamericanreview.org	scientific	wikidata
northcom.mil	usgov	usgov
notallowedto.com	fakenews	fakenewschecker
noticiaja.rac.com.br	news	wikidata
notrevoie.com	news	wikidata
nouvelliste.ch	news	wikidata
novayagazeta.ru	news	wikidata
novell.com	blog	wikidata
novitasroyal.org	scientific	wikidata
novus.no	scientific	wikidata
now8news.	fakenews	handcoded
now8news.com	fakenews	fakenewschecker
nowpublishers.com	scientific	wikidata
nowtheendbegins.com	clickbait|fakenews	fakenewschecker|handcoded
nowthisnews.com	fakenews	handcoded
npar.ru	scientific	wikidata
npjournal.org	scientific	wikidata
npr.org	news	handcoded
nps.gov	usgov	usgov
nq.oxfordjournals.org	scientific	wikidata
nrc.gov	usgov	usgov
nrc.nl	news	wikidata
nrc.uscg.mil	usgov	usgov
nrcresearchpress.com	scientific	wikidata
nrcs.usda.gov	usgov	usgov
nrfh.colmex.mx	scientific	wikidata
nro.gov	usgov	usgov
nro.sagepub.com	scientific	wikidata
nrronline.org	scientific	wikidata
nrz.de	news	wikidata
nsa.gov	usgov	usgov
nsd.rdc.noaa.gov	usgov	usgov
nsf.gov	usgov	usgov
nsku.org.ua	scientific	wikidata
nsq.sagepub.com	scientific	wikidata
nst.com.my	news	wikidata
ntia.doc.gov	usgov	usgov
ntik.dk	scientific	wikidata
ntis.gov	usgov	usgov
ntnu.no	scientific	wikidata
ntr.oxfordjournals.org	scientific	wikidata
ntsb.gov	usgov	usgov
ntvg.nl	scientific	wikidata
nucleuscms.org	blog	wikidata
nuevaweb.diariocolatino.com	news	wikidata
nuevomundo.revues.org	scientific	wikidata
nugget.ca	news	wikidata
nuovavenezia.gelocal.it	news	wikidata
nurse-practitioners-and-physician-assistants.advanceweb.com	scientific	wikidata
nursesinaidscarejournal.org	scientific	wikidata
nursingmanagement.rcnpublishing.co.uk	scientific	wikidata
nutrition.org	scientific	handcoded
nutritionj.com	scientific	wikidata
nutritionjrnl.com	scientific	wikidata
nutritionreviews.oxfordjournals.org	scientific	wikidata
nv.gov	usgov	usgov
nvonews.com	news	handcoded
nvs.sagepub.com	scientific	wikidata
nvsos.gov	usgov	usgov
nwas.org	scientific	wikidata
nwcouncil.org	usgov	usgov
nwfdailynews.com	news	wikidata
nws.noaa.gov	usgov	usgov
nwtrb.gov	usgov	usgov
ny.gov	usgov	usgov
nyas.org	scientific	wikidata
nycgo.com	usgov	usgov
nydailynews.com	news	wikidata|handcoded
nylottery.ny.gov	usgov	usgov
nymag.com	news	handcoded
nypost.com	news	wikidata
nyrsf.com	scientific	wikidata
nys.dk	scientific	wikidata
nysun.com	news	wikidata
nytimes.com	news	wikidata|handcoded
nzasia.org.nz	scientific	wikidata
nzcps.co.nz	scientific	wikidata
nzjf.org	scientific	wikidata
nzma.org.nz	scientific	wikidata
nzz.ch	news	wikidata
oa.mo.gov	usgov	usgov
oae.sagepub.com	scientific	wikidata
oakridge.doe.gov	usgov	usgov
oanow.com	news	wikidata
obamawhitehouse.archives.gov	news	handcoded
observer.com	news	handcoded
ocala.com	news	wikidata
occ.gov	usgov	usgov
occ.treas.gov	usgov	usgov
occmed.oxfordjournals.org	scientific	wikidata
occupydemocrats.com	fakenews	fakenewschecker|handcoded
occuworld.org	blog	handcoded
ocean-science.net	scientific	wikidata
oceanservice.noaa.gov	usgov	usgov
ocregister.com	news	wikidata
od.nih.gov	usgov	usgov
odiogo.com	blog	wikidata
odt.co.nz	news	wikidata
oe24.at	news	wikidata
oea.gov	usgov	usgov
oeaw.ac.at	scientific	wikidata
oecd.org	scientific	wikidata
oem.bmjjournals.com	scientific	wikidata
oepf.org	scientific	wikidata
officelive.com	blog	handcoded
offices.sc.egov.usda.gov	usgov	usgov
ofr.gov	usgov	usgov
oge.gov	usgov	usgov
ogs.ny.gov	usgov	usgov
ohio.gov	usgov	usgov
ohiolottery.com	usgov	usgov
ohiostatepress.org	scientific	wikidata
oilgeopolitics.net	fakenews	fakenewschecker
ojjdp.gov	usgov	usgov
ojogo.pt	news	wikidata
ojoonline.org	scientific	wikidata
ojp.usdoj.gov	usgov	usgov
ojrd.com	scientific	wikidata
ojs.letras.up.pt	scientific	wikidata
ojs.lib.byu.edu	scientific	wikidata
ojs.ub.gu.se	scientific	wikidata
ojs.ub.uni-konstanz.de	scientific	wikidata
ok.gov	usgov	usgov
ok.ru	socialmedia	wikidata
okcupid.com	socialmedia	wikidata
oldenbourg-verlag.de	scientific	wikidata
oldham-chronicle.co.uk	news	wikidata
oldwww.just.edu.jo	scientific	wikidata
ole.clarin.com	news	wikidata
olschki.it	scientific	wikidata
omanobserver.om	news	wikidata
omicsonline.org	scientific	handcoded
omjournal.org	scientific	wikidata
omnifeed.com	news	handcoded
omv.dps.state.la.us	usgov	usgov
oneindia.com	news	handcoded
onguardonline.gov	usgov	usgov
online.jkmesh.com	blog	handcoded
online.liverpooluniversitypress.co.uk	scientific	wikidata
online.uni-hd.de	scientific	wikidata
online.wsj.com	news	wikidata
onlineconservativepress.com	fakenews	fakenewschecker
onlinejets.org	scientific	wikidata
onlinelibrary.wiley.com	scientific	wikidata
onomastics.ru	scientific	wikidata
onrr.gov	usgov	usgov
ons.org	scientific	wikidata
onsugar.com	blog	handcoded
oonfun.com	socialmedia	wikidata
ooyuz.com	commercial	handcoded
op-marburg.de	news	wikidata
op.se	news	wikidata
openchemistry.com	scientific	wikidata
openjournals.libs.uga.edu	scientific	wikidata
openphysics.com	scientific	wikidata
openworld.gov	usgov	usgov
opic.gov	usgov	usgov
opinione.it	news	wikidata
opluse.com	scientific	wikidata
opm.gov	usgov	usgov
opp.sagepub.com	scientific	wikidata
opticalengineering.spiedigitallibrary.org	scientific	wikidata
opticsinfobase.org	scientific	wikidata
opuscula.agh.edu.pl	scientific	wikidata
or.journal.informs.org	scientific	wikidata
orbistertius.unlp.edu.ar	scientific	wikidata
orchardproject.net	blog	wikidata
ordo-journal.com	scientific	wikidata
oregon.gov	usgov	usgov
oregonlive.com	news	wikidata
oregonlottery.org	usgov	usgov
org.sagepub.com	scientific	wikidata
organicandhealthy.org	blog	handcoded
orgsyn.org	scientific	wikidata
orientalbirdclub.org	scientific	wikidata
orientaldaily.on.cc	news	wikidata
orkut.com	socialmedia	wikidata
orm.sagepub.com	scientific	wikidata
oro.doe.gov	usgov	usgov
ortegaygasset.edu	scientific	wikidata
orthopaedic-nursing.com	scientific	wikidata
orthopaedicnursing.com	scientific	wikidata
orwac.org	scientific	wikidata
osapublishing.org	scientific	wikidata
osc.gov	usgov	usgov
osd.mil	usgov	usgov
osdgc.osd.mil	usgov	usgov
osha.gov	usgov	usgov
oshrc.gov	usgov	usgov
osmre.gov	usgov	usgov
osoyoostimes.com	news	wikidata
oss.sagepub.com	scientific	wikidata
osti.gov	usgov	usgov
ostp.gov	usgov	usgov
otexa.ita.doc.gov	usgov	usgov
other98.com	fakenews	handcoded
othervoices.org	scientific	wikidata
otojournal.org	scientific	wikidata
ottawacitizen.com	news	wikidata|handcoded
ottawasun.com	news	handcoded
ottopagine.it	news	wikidata
outlookindia.com	news	handcoded
overblog.com	blog	wikidata
ow.ly	commercial	handcoded
owenwisterreview.wordpress.com	scientific	wikidata
owler.com	commercial	handcoded
oxfordjournals.org	scientific	wikidata
oxrep.oxfordjournals.org	scientific	wikidata
ozclub.org	scientific	wikidata
pa.gov	usgov	usgov
pa.oxfordjournals.org	scientific	wikidata
paa.sagepub.com	scientific	wikidata
pacificaffairs.ubc.ca	scientific	wikidata
pacom.mil	usgov	usgov
paecon.net	scientific	wikidata
pages.emerson.edu	scientific	wikidata
pagina12.com.ar	news	wikidata
paherald.sk.ca	news	wikidata
paho.org	scientific	wikidata
painjournalonline.com	scientific	wikidata
pakalertpress.com	clickbait|fakenews	fakenewschecker|handcoded
pakbs.org	scientific	wikidata
pakistaniaat.org	scientific	wikidata
pakistantoday.com.pk	news	wikidata
palaios.sepmonline.org	scientific	wikidata
palaugov.org	usgov	usgov
paleo.revues.org	scientific	wikidata
paleopolis.rediris.es	scientific	wikidata
palges.de	scientific	wikidata
palgrave-journals.com	scientific	wikidata
palmbeachpost.com	news	wikidata
paloaltodailynews.com	news	wikidata
palottery.state.pa.us	usgov	usgov
pamelageller.com	fakenews	fakenewschecker
pap.es	scientific	wikidata
paper.li	blog	handcoded
papers.nips.cc	scientific	wikidata
papyrology.org	scientific	wikidata
parasite-journal.org	scientific	wikidata
parasitesandvectors.com	scientific	wikidata
paraven.net	blog	handcoded
paris-normandie.fr	news	wikidata
paris-turf.com	news	wikidata
parnaseo.uv.es	scientific	wikidata
parool.nl	news	wikidata
partialanswers.huji.ac.il	scientific	wikidata
particlenews.com	blog	handcoded
patch.com	blog	handcoded
patdollard.com	fakenews	fakenewschecker
paternosterperiodicals.co.uk	scientific	wikidata
patheos.com	blog	handcoded
patientslikeme.com	socialmedia	wikidata
patriotpost.us	blog	handcoded
patriotupdate.com	fakenews	fakenewschecker
pbgc.gov	usgov	usgov
pbi.sagepub.com	scientific	wikidata
pbq.drexel.edu	scientific	wikidata
pbs.org	videos	handcoded
pbsociety.org.pl	scientific	wikidata
pcauthority.com.au	news	handcoded
pch.sagepub.com	scientific	wikidata
pclob.gov	usgov	usgov
pcworld.com	news	handcoded
pdcnet.org	scientific	wikidata
pdj.sagepub.com	scientific	wikidata
pdk.sagepub.com	scientific	wikidata
pdnonline.com	scientific	wikidata
pe.com	news	wikidata
peacecorps.gov	usgov	usgov
pearlmag.com	scientific	wikidata
peckhamia.com	scientific	wikidata
ped.sagepub.com	scientific	wikidata
pediatric.theclinics.com	scientific	wikidata
pediatricneurosciences.com	scientific	wikidata
pediatricnursing.net	scientific	wikidata
pediatricobesity.net	scientific	wikidata
pediatrics.aappublications.org	scientific	wikidata
peerj.com	scientific	wikidata
peeters-leuven.be	scientific	wikidata
pemberleybooks.com	scientific	wikidata
pen.org	scientific	wikidata
pen.sagepub.com	scientific	wikidata
peninsulaclarion.com	news	wikidata
pennstatebehrend.psu.edu	scientific	wikidata
pensoft.net	scientific	wikidata
pentictonherald.ca	news	wikidata
people.carleton.edu	scientific	wikidata
people.com	news	handcoded
people.hsc.edu	scientific	wikidata
peoplesearch.hud.gov	usgov	usgov
pep.wiley-vch.de	scientific	wikidata
perceptionweb.com	scientific	wikidata
periodico.ebras.bio.br	scientific	wikidata
periodicos.ufsc.br	scientific	wikidata
periscope.com	socialmedia	handcoded
periscope.tv	socialmedia	handcoded
perlinguam.journals.ac.za	scientific	wikidata
persee.fr	scientific	wikidata
persianblog.ir	socialmedia	wikidata
persoonia.org	scientific	wikidata
perspectiveschinoises.revues.org	scientific	wikidata
perspectivesofnewmusic.org	scientific	wikidata
petrology.oxfordjournals.org	scientific	wikidata
pfpa.mil	usgov	usgov
pfr.sagepub.com	scientific	wikidata
pharmacotherapy.org	scientific	wikidata
pharmacypractice.org	scientific	wikidata
pharmazie.govi.de	scientific	wikidata
pharmrev.aspetjournals.org	scientific	wikidata
phcog.com	scientific	wikidata
phcogcommn.org	scientific	wikidata
phcogres.com	scientific	wikidata
phcogrev.com	scientific	wikidata
phg.sagepub.com	scientific	wikidata
philippinestudies.net	scientific	wikidata
philly.com	news	wikidata
philosophy.emory.edu	scientific	wikidata
phl.sagepub.com	scientific	wikidata
phmsa.dot.gov	usgov	usgov
phonebook.doe.gov	usgov	usgov
photonicsforenergy.spiedigitallibrary.org	scientific	wikidata
photostreet.com	blog	handcoded
phy.duke.edu	scientific	wikidata
phys.org	news	handcoded
physics.aps.org	scientific	wikidata
physicsessays.org	scientific	wikidata
physicstoday.org	scientific	wikidata
physiologicalreports.org	scientific	wikidata
physiologyonline.physiology.org	scientific	wikidata
physiotherapy.asn.au	scientific	wikidata
physrev.physiology.org	scientific	wikidata
physsportsmed.org	scientific	wikidata
phytokeys.pensoft.net	scientific	wikidata
phytomedicinejournal.com	scientific	wikidata
phytoneuron.net	scientific	wikidata
pigment.org	scientific	wikidata
piirus.com	socialmedia	wikidata
pikabu.ru	socialmedia	wikidata
pinterest.com	socialmedia	wikidata
pintrest.com	socialmedia	handcoded
pirineos.revistas.csic.es	scientific	wikidata
pitt.edu	scientific	wikidata
pivotx.net	blog	wikidata
pixelpost.org	blog	wikidata
pjahs.ust.edu.ph	scientific	wikidata
pjm.math.berkeley.edu	scientific	wikidata
pjmedia.com	blog	handcoded
pjps.pk	scientific	wikidata
pjss.iscte.pt	scientific	wikidata
placentajournal.org	scientific	wikidata
plag.com	socialmedia	wikidata
plantcell.org	scientific	wikidata
plantnet.rbgsyd.nsw.gov.au	scientific	wikidata
plantphysiol.org	scientific	wikidata
plantsystematics.com	scientific	wikidata
plasreconsurg.com	scientific	wikidata
platinummetalsreview.com	scientific	wikidata
plh.univ-tlse2.fr	scientific	wikidata
plos.org	scientific	handcoded
plosbiology.org	scientific	wikidata
plosgenetics.org	scientific	wikidata
plosmedicine.org	scientific	wikidata
plosntds.org	scientific	wikidata
plosone.org	scientific	wikidata
plus.google.com	socialmedia	wikidata
pluxml.org	blog	wikidata
pmj.bmj.com	scientific	wikidata
pmj.sagepub.com	scientific	wikidata
pnas.org	news|scientific	wikidata|handcoded
pndr.co	socialmedia	wikidata
pocketgamer.co.uk	news	handcoded
poeticstoday.dukejournals.org	scientific	wikidata
pof.aip.org	scientific	wikidata
poi.sagepub.com	scientific	wikidata
point24.lu	news	wikidata
poj.peeters-leuven.be	scientific	wikidata
polarresearch.net	scientific	wikidata
pole-sud.edu.umontpellier.fr	scientific	wikidata
polish-sociological-review.eu	scientific	wikidata
politicalblindspot.com	clickbait|fakenews	fakenewschecker|handcoded
politicalcult.com	fakenews	fakenewschecker
politicalears.com	fakenews	handcoded
politicalo.com	fakenews	handcoded
politicalreviewer.com	fakenews	fakenewschecker
politicalupdater.com	fakenews	fakenewschecker
politicalvelcraft.org	fakenews	fakenewschecker
politico.com	news	handcoded
politicops.com	fakenews	fakenewschecker
politicot.com	fakenews	handcoded
politicsandthelifesciences.org	scientific	wikidata
politicususa.com	fakenews	fakenewschecker|handcoded
politika.rs	news	wikidata
politique-africaine.com	scientific	wikidata
polygon.com	news	handcoded
pop.aip.org	scientific	wikidata
popastro.com	scientific	wikidata
pophealthmetrics.biomedcentral.com	scientific	wikidata
popsci.com	news	handcoded
popsugar.com	news	handcoded
popumed.com	scientific	wikidata
portal.ct.gov	usgov	usgov
portal.ehawaii.gov	usgov	usgov
portal.hud.gov	usgov	usgov
portal.state.pa.us	scientific	wikidata
portal.uspto.gov	usgov	usgov
portlanddailysun.me	news	wikidata
post-gazette.com	news	wikidata
posta.com.tr	news	wikidata
postach.io	blog	handcoded
postalinspectors.uspis.gov	usgov	usgov
postcourier.com.pg	news	wikidata
posterous.com	blog	handcoded
postgradmed.org	scientific	wikidata
postimees.ee	news	wikidata
postregister.com	news	wikidata
postroadmag.com	scientific	wikidata
ppa.sagepub.com	scientific	wikidata
ppg.sagepub.com	scientific	wikidata
pps.sagepub.com	scientific	wikidata
pra.aps.org	scientific	wikidata
prairieschooner.unl.edu	scientific	wikidata
praksis.org	scientific	wikidata
pravda.sk	news	wikidata
pravdareport.com	fakenews	fakenewschecker
pravo.novinky.cz	news	wikidata
praxisfilosofica.univalle.edu.co	scientific	wikidata
prb.sagepub.com	scientific	wikidata
prc.aps.org	scientific	wikidata
prc.gov	usgov	usgov
prd.aps.org	scientific	wikidata
prealpina.it	news	wikidata
precedings.nature.com	scientific	wikidata
prehistoire.org	scientific	wikidata
prensalibre.com	news	wikidata
prescott.edu	scientific	wikidata
prescrire.org	scientific	wikidata
present.fr	news	wikidata
preservationnation.org	scientific	wikidata
presidio.gov	usgov	usgov
presidiotrust.gov	usgov	usgov
press.huc.edu	scientific	wikidata
press.jhu.edu	scientific	wikidata
press.uchicago.edu	scientific	wikidata
press.uillinois.edu	scientific	wikidata
pressesagro.be	scientific	wikidata
pressesdesciencespo.fr	scientific	wikidata
pressrepublican.com	news	wikidata
presstelegram.com	news	wikidata
presstv.ir	fakenews	fakenewschecker
prf.sagepub.com	scientific	wikidata
primorski.eu	news	wikidata
princegeorgecitizen.com	news	wikidata
printly.net	fakenews	handcoded
prisonplanet.com	clickbait|fakenews	fakenewschecker|handcoded
prisonplanet.tv	clickbait|fakenews	handcoded
private-eye.co.uk	fakenews	fakenewschecker|handcoded
prl.aps.org	scientific	wikidata
prlog.org	blog	handcoded
prntly.com	fakenews	fakenewschecker
pro.sagepub.com	scientific	wikidata
pro.tsv.fi	scientific	wikidata
proceedings.aip.org	scientific	wikidata
program	usgov	usgov
projecteuclid.org	scientific	wikidata
projectveritas.com	fakenews	handcoded
promodj.com	socialmedia	wikidata
promotedstories.com	commercial	handcoded
protectyourmove.gov	usgov	usgov
protein.bio.msu.su	scientific	wikidata
proteinscience.org	scientific	wikidata
proudcons.com	fakenews	fakenewschecker
prouddemocrat.com	fakenews	handcoded
provancher.qc.ca	scientific	wikidata
providenceseminary.ca	scientific	wikidata
prst-ab.aps.org	scientific	wikidata
prst-per.aps.org	scientific	wikidata
prx.aps.org	scientific	wikidata
pshares.org	scientific	wikidata
psi.sagepub.com	scientific	wikidata
psp.sagepub.com	scientific	wikidata
psqonline.org	scientific	wikidata
psr.sagepub.com	scientific	wikidata
psroc.phys.ntu.edu.tw	scientific	wikidata
pss.sagepub.com	scientific	wikidata
psupress.org	scientific	wikidata
psy-journal.com	scientific	wikidata
psyanima.su	scientific	wikidata
psyche.entclub.org	scientific	wikidata
psychgenetics.com	scientific	wikidata
psychiatrictimes.com	scientific	wikidata
psychiatrist.com	scientific	wikidata
psycho-clinique.org	scientific	wikidata
psychologicabelgica.com	scientific	wikidata
psychologyinrussia.com	scientific	wikidata
psychosomaticmedicine.org	scientific	wikidata
psychosomaticsjournal.org	scientific	wikidata
psychservices.psychiatryonline.org	scientific	wikidata
psyjournals.ru	scientific	wikidata
psypress.com	scientific	wikidata
ptep-online.com	scientific	wikidata
ptep.oxfordjournals.org	scientific	wikidata
ptice.si	scientific	wikidata
pubblicogiornale.it	news	wikidata
public.navy.mil	usgov	usgov
publica.webs.ull.es	scientific	wikidata
publicaciones.unirioja.es	scientific	wikidata
publicaciones.uva.es	scientific	wikidata
publications.ossrea.net	scientific	wikidata
publichealthjrnl.com	scientific	wikidata
publichealthreports.org	scientific	wikidata
publico.es	news	wikidata
publico.pt	news	wikidata
publicsurplus.com	usgov	usgov
publish.csiro.au	scientific	wikidata
publius.oxfordjournals.org	scientific	wikidata
pubs.acs.org	scientific	wikidata
pubs.nrc-cnrc.gc.ca	scientific	wikidata
pubs.rsc.org	scientific	wikidata
pubsonline.informs.org	scientific	wikidata
pubstemcell.com	scientific	wikidata
puf.com	scientific	wikidata
pulsus.com	scientific	wikidata
pump.io	blog	wikidata
punkt.ch	news	wikidata
purchasing.utah.gov	usgov	usgov
pus.sagepub.com	scientific	wikidata
pus.unistra.fr	scientific	wikidata
pvs.sagepub.com	scientific	wikidata
pwm.sagepub.com	scientific	wikidata
pz-news.de	news	wikidata
qds.it	news	wikidata
qhr.sagepub.com	scientific	wikidata
qix.sagepub.com	scientific	wikidata
qjae.org	scientific	wikidata
qje.oxfordjournals.org	scientific	wikidata
qoura.com	blog	handcoded
qpolitical.com	fakenews	fakenewschecker
qrj.sagepub.com	scientific	wikidata
qroom.ru	socialmedia	wikidata
qsjournal.com.cn	scientific	wikidata
qsw.sagepub.com	scientific	wikidata
quaibranly.fr	scientific	wikidata
qualitative-research.net	scientific	wikidata
qualitysafety.bmj.com	scientific	wikidata
quarterlywest.com	scientific	wikidata
que.es	news	wikidata
quest-journal.net	scientific	wikidata
quimicanova.sbq.org.br	scientific	wikidata
quizilla.com	blog	handcoded
quodlibet.net	scientific	wikidata
quotidiano.net	news	wikidata
quotidianodelsud.it	news	wikidata
quotidianodipuglia.it	news	wikidata
qz.com	news	handcoded
rac.es	scientific	wikidata
raccefyn.co	scientific	wikidata
racefromthefinish.com	commercial	handcoded
racgp.org.au	scientific	wikidata
raco.cat	scientific	wikidata
radikal.com.tr	news	wikidata
radio-canada.ca	news	handcoded
radio.userland.com	blog	wikidata
radiochimica-acta.de	scientific	wikidata
radioelektronika.org	scientific	wikidata
radiographyonline.com	scientific	wikidata
radiology.rsna.org	scientific	wikidata
rande.org	scientific	wikidata
rangifer.no	scientific	wikidata
raptorresearchfoundation.org	scientific	wikidata
raritanquarterly.rutgers.edu	scientific	wikidata
ras.sagepub.com	scientific	wikidata
rasc.ca	scientific	wikidata
ravelry.com	socialmedia	wikidata
rawstory.com	fakenews	fakenewschecker
rb.no	news	wikidata
rbg.vic.gov.au	scientific	wikidata
rcb.sagepub.com	scientific	wikidata
rchn.biologiachile.cl	scientific	wikidata
rcjournal.com	scientific	wikidata
rcnpublishing.com	scientific	wikidata
rcpe.ac.uk	scientific	wikidata
rcplondon.ac.uk	scientific	wikidata
rd.usda.gov	usgov	usgov
rdtp.revistas.csic.es	scientific	wikidata
react365.com	fakenews	handcoded
readconservatives.news	fakenews	fakenewschecker
readfulapp.com	commercial	handcoded
readthebestwriting.com	scientific	wikidata
ready.gov	usgov	usgov
reagancoalition.com	fakenews	fakenewschecker
realclearpolitics.com	blog	handcoded
realfarmacy.com	clickbait|fakenews	handcoded
realnewsrightnow.com	fakenews	fakenewschecker|handcoded
realtimepolitics.com	fakenews	fakenewschecker
recalls.gov	usgov	usgov
recode.net	news	handcoded
records.sigmm.ndlab.net	scientific	wikidata
red-sweater.com	blog	wikidata
redc.revistas.csic.es	scientific	wikidata
reddeeradvocate.com	news	wikidata
redding.com	news	wikidata
reddit.com	socialmedia	wikidata|handcoded
redeyechicago.com	news	wikidata
redflagnews.com	clickbait|fakenews	fakenewschecker|handcoded
redgage.com	commercial	handcoded
redjournal.org	scientific	wikidata
redlandsdailyfacts.com	news	wikidata
redrocktribune.com	fakenews	handcoded
redstate.com	news	handcoded
redstates.com	fakenews	handcoded
redstatewatcher.com	fakenews	fakenewschecker
reductress.com	fakenews	handcoded
redwoodcitydailynews.com	news	wikidata
reep.oxfordjournals.org	scientific	wikidata
reflexe.cz	scientific	wikidata
reforma.com	news	wikidata
reg.u-bordeaux3.fr	scientific	wikidata
reginfo.gov	usgov	usgov
rehab.research.va.gov	scientific	wikidata
rei.revues.org	scientific	wikidata
rekihaku.ac.jp	scientific	wikidata
rel.sagepub.com	scientific	wikidata
relaquim.com	scientific	wikidata
relat.org	scientific	wikidata
relativity.livingreviews.org	scientific	wikidata
remmm.revues.org	scientific	wikidata
remotesensing.spiedigitallibrary.org	scientific	wikidata
rendiconti.math.unipd.it	scientific	wikidata
renditions.org	scientific	wikidata
rense.com	fakenews	fakenewschecker
reporternews.com	news	wikidata
representations.org	scientific	wikidata
reproduction-online.org	scientific	wikidata
repubblica.it	news	wikidata
republicain-lorrain.fr	news	wikidata
republicbroadcasting.org	blog	handcoded
republikein.com.na	news	wikidata
reru.gretha.u-bordeaux4.fr	scientific	wikidata
res.org.uk	scientific	wikidata
res.oxfordjournals.org	scientific	wikidata
research.ibm.com	scientific	wikidata
researchgate.net	socialmedia|scientific	wikidata|handcoded
researchinlearningtechnology.net	scientific	wikidata
respiratory-research.com	scientific	wikidata
ress.revues.org	scientific	wikidata
restud.com	scientific	wikidata
resuscitationjournal.com	scientific	wikidata
rethinkingmarxism.org	scientific	wikidata
reuters.com	news	handcoded
reuters.us.feedsportal.com	news	handcoded
review.antiochcollege.org	scientific	wikidata
reviewjournal.com	news	wikidata
reviewofmetaphysics.org	scientific	wikidata
revintsociologia.revistas.csic.es	scientific	wikidata
revista-hc.com	scientific	wikidata
revista.inecc.gob.mx	scientific	wikidata
revistacritica.es	scientific	wikidata
revistadefilologiaespañola.revistas.csic.es	scientific	wikidata
revistadeindias.revistas.csic.es	scientific	wikidata
revistademetalurgia.revistas.csic.es	scientific	wikidata
revistadyna.com	scientific	wikidata
revistaestudiosregionales.com	scientific	wikidata
revistafilosofia.uchile.cl	scientific	wikidata
revistahistoriamoderna.ua.es	scientific	wikidata
revistahistoriapsicologia.es	scientific	wikidata
revistapadurilor.com	scientific	wikidata
revistas-filologicas.unam.mx	scientific	wikidata
revistas.pucp.edu.pe	scientific	wikidata
revistas.uam.es	scientific	wikidata
revistas.ucm.es	scientific	wikidata
revistas.um.es	scientific	wikidata
revistas.unal.edu.co	scientific	wikidata
revistas.unam.mx	scientific	wikidata
revistas.uned.es	scientific	wikidata
revistas.upr.edu	scientific	wikidata
revistas.usal.es	scientific	wikidata
revistas.uv.cl	scientific	wikidata
revistaseletronicas.pucrs.br	scientific	wikidata
revistaseug.ugr.es	scientific	wikidata
revistasonline.inap.es	scientific	wikidata
revistavegueta.ulpgc.es	scientific	wikidata
revistes.ub.edu	scientific	wikidata
revolutions2040.com	fakenews	fakenewschecker
revue-de-synthese.eu	scientific	wikidata
revue-economique.fr	scientific	wikidata
revue-egypte.org	scientific	wikidata
revue-metallurgie.org	scientific	wikidata
revue.etudes-episteme.org	scientific	wikidata
revuecites.wordpress.com	scientific	wikidata
revuedecapage.blogspot.fr	scientific	wikidata
revuedeneuropsychologie.com	scientific	wikidata
revuedesdeuxmondes.fr	scientific	wikidata
revuefrancaisedeconomie.fr	scientific	wikidata
revueinternationalepme.com	scientific	wikidata
revues-gallia.cnrs.fr	scientific	wikidata
revues.armand-colin.com	scientific	wikidata
rfa.org	usgov	usgov
rferl.org	usgov	usgov
rfg.revuesonline.com	scientific	wikidata
rfp.revues.org	scientific	wikidata
rfs-revue.com	scientific	wikidata
rga.revues.org	scientific	wikidata
rgdip.com	scientific	wikidata
rh19.revues.org	scientific	wikidata
rha.revues.org	scientific	wikidata
rhe-jilaeh.com	scientific	wikidata
rheumatology.oupjournals.org	scientific	wikidata
rhm.pennpress.org	scientific	wikidata
rhmjournal.org.uk	scientific	wikidata
rhodora.org	scientific	wikidata
rhpr.net	scientific	wikidata
rhr.revues.org	scientific	wikidata
ri.gov	usgov	usgov
ria.ie	scientific	wikidata
ribbs.usps.gov	usgov	usgov
rickwells.us	fakenews	fakenewschecker
rienner.com	scientific	wikidata
rightalerts.com	fakenews	fakenewschecker
rightwingnews.com	fakenews	fakenewschecker
riifr.univ-littoral.fr	scientific	wikidata
rilenews.com	fakenews	fakenewschecker|handcoded
rilot.com	usgov	usgov
rinascita.eu	news	wikidata
riojournal.com	scientific	wikidata
risk.net	scientific	wikidata
rita.dot.gov	usgov	usgov
rivista-statistica.unibo.it	scientific	wikidata
rizospastis.gr	news	wikidata
rjb.revistas.csic.es	scientific	wikidata
rje.org	scientific	wikidata
rlv.revues.org	scientific	wikidata
rma.usda.gov	usgov	usgov
rmcg.unam.mx	scientific	wikidata
rmi-op.net	usgov	usgov
rmi.ge	scientific	wikidata
rmiembassyus.org	usgov	usgov
rmmc.eas.asu.edu	scientific	wikidata
rmp.aps.org	scientific	wikidata
rms.medhyg.ch	scientific	wikidata
rnajournal.cshlp.org	scientific	wikidata
roa.sagepub.com	scientific	wikidata
roanokereview.wordpress.com	scientific	wikidata
rockcitytimes.com	satire|fakenews	fakenewschecker|handcoded
rockymountainnews.com	news	wikidata
rocskincare.com	commercial	handcoded
rodopi.nl	scientific	wikidata
rodriguesia.jbrj.gov.br	scientific	wikidata
rogavis.no	news	wikidata
rollcall.com	news	handcoded
roller.apache.org	blog	wikidata
rollingstone.com	news	handcoded
romagnanoi.it	news	wikidata
romancestudies.cornell.edu	scientific	wikidata
rop.sagepub.com	scientific	wikidata
rosenbergesellier.it	scientific	wikidata
royalgazette.com	news	wikidata
royensoc.co.uk	scientific	wikidata
rp-online.de	news	wikidata
rp.pl	news	wikidata
rpd.oxfordjournals.org	scientific	wikidata
rpd.unibo.it	scientific	wikidata
rrb.gov	usgov	usgov
rre.sagepub.com	scientific	wikidata
rs9.loc.gov	usgov	usgov
rsa.revues.org	scientific	wikidata
rsaa.org.uk	scientific	wikidata
rsabg.org	scientific	wikidata
rsbl.royalsocietypublishing.org	scientific	wikidata
rsc.org	scientific	wikidata
rse.sagepub.com	scientific	wikidata
rseq.org	scientific	wikidata
rsh.sagepub.com	scientific	wikidata
rsi.aip.org	scientific	wikidata
rsif.royalsocietypublishing.org	scientific	wikidata
rsmas.miami.edu	scientific	wikidata
rsnz.natlib.govt.nz	scientific	wikidata
rso.cornell.edu	scientific	wikidata
rsob.royalsocietypublishing.org	scientific	wikidata
rspa.royalsocietypublishing.org	scientific	wikidata
rss.cnn.com	news	handcoded
rss.nytimes.com	news	handcoded
rss.org.uk	scientific	wikidata
rss.sagepub.com	scientific	wikidata
rsta.royalsocietypublishing.org	scientific	wikidata
rstb.royalsocietypublishing.org	scientific	wikidata
rstl.royalsocietypublishing.org	scientific	wikidata
rsw.sagepub.com	scientific	wikidata
rswa.org.au	scientific	wikidata
rsx.sagepub.com	scientific	wikidata
rt.com	fakenews	fakenewschecker
rubber.org	scientific	wikidata
ruhrnachrichten.de	news	wikidata
rumormillnews.com	fakenews	fakenewschecker
ruptly.tv	fakenews	fakenewschecker
rurdev.usda.gov	usgov	usgov
rusq.org	scientific	wikidata
russia-direct.org	fakenews	fakenewschecker
russianreview.org	scientific	wikidata
rutlandherald.com	news	wikidata
ryze.com	socialmedia	wikidata
s.einnews.com	blog	handcoded
s9y.org	blog	wikidata
sa2.www4.irs.gov	usgov	usgov
saao.ac.za	scientific	wikidata
saarbruecker-zeitung.de	news	wikidata
saber.ula.ve	scientific	wikidata
sabrang.com	scientific	wikidata
sac-oac.ca	scientific	wikidata
sacaaa.org	scientific	wikidata
sad.sagepub.com	scientific	wikidata
sadaf.org.ar	scientific	wikidata
sae.sagepub.com	scientific	wikidata
saem.org	scientific	wikidata
saferproducts.gov	usgov	usgov
safnet.org	scientific	wikidata
sag.sagepub.com	scientific	wikidata
sagepub.com	news|scientific	wikidata|handcoded
saisreview.org	scientific	wikidata
sait.oat.ts.astro.it	scientific	wikidata
saj.matf.bg.ac.rs	scientific	wikidata
sajg.geoscienceworld.org	scientific	wikidata
sajs.co.za	scientific	wikidata
salon.com	news	handcoded
salongo.best.cd	news	wikidata
samhsa.gov	usgov	usgov
samhsa.hhs.gov	usgov	usgov
samj.org.za	scientific	wikidata
samla.gsu.edu	scientific	wikidata
samuel-warde.com	fakenews	fakenewschecker
sandiegoshellclub.com	scientific	wikidata
sandiegouniontribune.com	news	wikidata
sankei.jp	news	wikidata
sankhya.isical.ac.in	scientific	wikidata
sanluisobispo.com	news	wikidata
sanp.ch	scientific	wikidata
sar.sagepub.com	scientific	wikidata
sas.sagepub.com	scientific	wikidata
satakunnankansa.fi	news	wikidata
satiratribune.com	fakenews	handcoded
satirewire.com	fakenews	fakenewschecker|handcoded
saultstar.com	news	wikidata
sax.sagepub.com	scientific	wikidata
sba.gov	usgov	usgov
sbf.c.se	scientific	wikidata
sbjchem.he.com.br	scientific	wikidata
sbnation.com	news	handcoded
sbsun.com	news	wikidata
sc.gov	usgov	usgov
scan.oxfordjournals.org	scientific	wikidata
scdailypress.com	news	wikidata
scdmvonline.com	usgov	usgov
sceducationlottery.com	usgov	usgov
scf.hhs.gov	usgov	usgov
scfbm.org	scientific	wikidata
schattauer.de	scientific	wikidata
schizophreniabulletin.oxfordjournals.org	scientific	wikidata
schlegel-gesellschaft.de	scientific	wikidata
schmollersjahrbuch.de	scientific	wikidata
scholarshipamerica.org	usgov	usgov
scholarspace.manoa.hawaii.edu	scientific	wikidata
scholarworks.iu.edu	scientific	wikidata
schweizerbart.de	scientific	wikidata
sciam.com	news	handcoded
scielo.br	scientific	wikidata
scielo.cl	scientific	wikidata
scielo.org.ar	scientific	wikidata
scielo.org.co	scientific	wikidata
scielo.sld.cu	scientific	wikidata
scienca-revuo.info	scientific	wikidata
science.energy.gov	usgov	usgov
science.smith.edu	scientific	wikidata
sciencealert.com	blog	handcoded
scienceandsociety.com	scientific	wikidata
scienceblogs.com	blog	handcoded
sciencedaily.com	news	handcoded
sciencedirect.com	scientific	wikidata|handcoded
sciencedomain.org	scientific	wikidata
sciencefromisrael.com	scientific	wikidata
sciencemag.org	news|scientific	wikidata|handcoded
scientificexploration.org	scientific	wikidata
scinexx.de	scientific	wikidata
scipharm.at	scientific	wikidata
scirp.org	scientific	wikidata
scitation.aip.org	scientific	wikidata
sciweb.nybg.org	scientific	wikidata
scm.sagepub.com	scientific	wikidata
scmagazine.com	news	handcoded
scmp.com	news	wikidata
scmsgroup.org	scientific	wikidata
scoliosisjournal.biomedcentral.com	scientific	wikidata
scoop.it	commercial	handcoded
scotsman.com	news	wikidata
scp.sagepub.com	scientific	wikidata
scrappleface.com	fakenews	fakenewschecker|handcoded
screen.arts.gla.ac.uk	scientific	wikidata
scribd.com	blog	handcoded
scriptageologica.nl	scientific	wikidata
scriptorium.be	scientific	wikidata
scs.uiuc.edu	scientific	wikidata
scv.sagepub.com	scientific	wikidata
scvotes.org	usgov	usgov
scx.sagepub.com	scientific	wikidata
sd.gov	usgov	usgov
sdos.ejournal.ascc.net	scientific	wikidata
sdsos.gov	usgov	usgov
sdu.edu.tr	scientific	wikidata
sea-entomologia.org	scientific	wikidata
seattleorganicrestaurants.com	commercial	handcoded
seattlepi.com	news	wikidata
seattletimes.com	news	wikidata
seaway.dot.gov	usgov	usgov
sec.gov	usgov	usgov
sec.state.ma.us	usgov	usgov
sec.state.vt.us	usgov	usgov
secheresse.info	scientific	wikidata
secoloditalia.it	news	wikidata
secretservice.gov	usgov	usgov
secretsofthefed.com	fakenews	fakenewschecker
secstates.com	usgov	usgov
secure.jten.mil	usgov	usgov
secure.medicalletter.org	scientific	wikidata
secure.pdcnet.org	scientific	wikidata
secure.ssa.gov	usgov	usgov
security-and-peace.de	scientific	wikidata
sed.sagepub.com	scientific	wikidata
seepuertorico.com	usgov	usgov
seesmic.com	blog	wikidata
sef.nu	scientific	wikidata
sefarad.revistas.csic.es	scientific	wikidata
seikyonet.jp	news	wikidata
seismosoc.org	scientific	wikidata
self.com	news	handcoded
selloeditorial.udec.cl	scientific	wikidata
selmatimesjournal.com	news	wikidata
seminariomatematico.dm.unito.it	scientific	wikidata
seminascientiarum.wikidot.com	scientific	wikidata
seminperinat.com	scientific	wikidata
senate.gov	usgov	usgov
sensationalisttimes.com	fakenews	fakenewschecker
senscritique.com	socialmedia	wikidata
sensesofcinema.com	scientific	wikidata
sepa.doe.gov	usgov	usgov
septentrio.uit.no	scientific	wikidata
serket2008.multiply.com	scientific	wikidata
sett.com	blog	handcoded
sewanee.edu	scientific	wikidata
sex.sagepub.com	scientific	wikidata
sexscience.org	scientific	wikidata
sf-foundation.org	scientific	wikidata
sf.oxfordjournals.org	scientific	wikidata
sfgate.com	news	wikidata
sfp.asso.fr	scientific	wikidata
sfsrfs.org	scientific	wikidata
sgr.sagepub.com	scientific	wikidata
sh.st	commercial	handcoded
shao.az	scientific	wikidata
shareasale.com	commercial	handcoded
sharylattkisson.com	blog	handcoded
sheepkillers.com	fakenews	fakenewschecker
shellmuseum.org	scientific	wikidata
shenandoahliterary.org	scientific	wikidata
sherbrookerecord.com	news	wikidata
shm.sagepub.com	scientific	wikidata
shoebat.com	fakenews	fakenewschecker
sht.ut.ee	scientific	wikidata
shtfplan.com	fakenews	fakenewschecker
si.com	news	handcoded
si.edu	usgov	usgov
siam.org	scientific	wikidata
sibios.area.fi.cnr.it	scientific	wikidata
sieds.it	scientific	wikidata
sific.it	news	wikidata
sify.com	news	handcoded
sigmaaldrich.com	scientific	wikidata
sigmobile.org	scientific	wikidata
signalprocessingsociety.org	scientific	wikidata
signsjournal.org	scientific	wikidata
sih.sagepub.com	scientific	wikidata
sikhsiyasat.com	news	handcoded
sil.org	scientific	wikidata
sil.si.edu	scientific	wikidata
silvagabreta.npsumava.cz	scientific	wikidata
sim.sagepub.com	scientific	wikidata
simcoereformer.ca	news	wikidata
simh.seele-brennt.com	scientific	wikidata
singpao.com	news	wikidata
singtao.ca	news	wikidata
singtao.com	news	wikidata
sino-platonic.org	scientific	wikidata
sioc-journal.cn	scientific	wikidata
site.uit.no	scientific	wikidata
sites.computer.org	scientific	wikidata
sites.google.com	usgov|scientific	usgov|wikidata
sites.ieee.org	scientific	wikidata
sitkasentinel.com	news	wikidata
sji.gov	usgov	usgov
sjp.sagepub.com	scientific	wikidata
sjs.sagepub.com	scientific	wikidata
sjweb.info	scientific	wikidata
sjweh.fi	scientific	wikidata
skepticalraptor.com	blog	handcoded
skeptiko.com	fakenews	fakenewschecker
sketch-life.jp	socialmedia	wikidata
skincancer.org	news	handcoded
skyandtelescope.com	scientific	wikidata
slackjournals.com	scientific	wikidata
slate.com	news	handcoded
slavicreview.illinois.edu	scientific	wikidata
slideshare.com	blog	handcoded
sljol.info	scientific	wikidata
sloanreview.mit.edu	scientific	wikidata
sls.sagepub.com	scientific	wikidata
small-journal.com	scientific	wikidata
smallbiztrends.com	blog	handcoded
smf.emath.fr	scientific	wikidata
smf4.emath.fr	scientific	wikidata
smh.sagepub.com	scientific	wikidata
smithsonianmag.com	news	handcoded
smj.org.sa	scientific	wikidata
smm.sagepub.com	scientific	wikidata
smp.se	news	wikidata
smq.sagepub.com	scientific	wikidata
smr.sagepub.com	scientific	wikidata
smu.edu	scientific	wikidata
snip.ly	commercial	handcoded
snreview.org	scientific	wikidata
soas.ac.uk	scientific	wikidata
sobornost.org	scientific	wikidata
sobp.org	scientific	wikidata
soci.org	scientific	wikidata
social.wakoopa.com	socialmedia	wikidata
socialiststudies.com	scientific	wikidata
socialtextjournal.org	scientific	wikidata
societabotanicaitaliana.it	scientific	wikidata
societedesetudeslatines.com	scientific	wikidata
sociologiedutravail.org	scientific	wikidata
sociologieetsocietes.ca	scientific	wikidata
sociology.org	scientific	wikidata
socom.mil	usgov	usgov
socresonline.org.uk	scientific	wikidata
soe.sagepub.com	scientific	wikidata
sol.lu.se	scientific	wikidata
solarphysics.livingreviews.org	scientific	wikidata
songyuan.org	scientific	wikidata
sonic.net	scientific	wikidata
sonicdesign.org	scientific	wikidata
sorites.org	scientific	wikidata
sos.arkansas.gov	usgov	usgov
sos.ca.gov	usgov	usgov
sos.idaho.gov	usgov	usgov
sos.iowa.gov	usgov	usgov
sos.la.gov	usgov	usgov
sos.mo.gov	usgov	usgov
sos.ms.gov	usgov	usgov
sos.mt.gov	usgov	usgov
sos.ne.gov	usgov	usgov
sos.oregon.gov	usgov	usgov
sos.state.co.us	usgov	usgov
sos.state.nm.us	usgov	usgov
sos.state.oh.us	usgov	usgov
sos.state.tx.us	usgov	usgov
sos.wa.gov	usgov	usgov
sos.wv.gov	usgov	usgov
soswy.state.wy.us	usgov	usgov
sosym.org	scientific	wikidata
sott.net	fakenews	fakenewschecker
soundcloud.com	socialmedia	wikidata
soup.io	blog	wikidata
sourcefabric.org	blog	wikidata
southcom.mil	usgov	usgov
southernspaces.org	scientific	wikidata
southwalesargus.co.uk	news	wikidata
spandidos-publications.com	scientific	wikidata
spd.dcu.ie	scientific	wikidata
specgram.com	scientific	wikidata
spectroscopyeurope.com	scientific	wikidata
speld.nl	fakenews	handcoded
spi.sagepub.com	scientific	wikidata
spie.org	scientific	wikidata
spinejournal.com	scientific	wikidata
spirula.nl	scientific	wikidata
sponichi.co.jp	news	wikidata
sport.es	news	wikidata
sportsnet.ca	news	handcoded
spq.sagepub.com	scientific	wikidata
springer.com	scientific	wikidata|handcoded
springerlink.com	scientific	wikidata
springerlink.metapress.com	scientific	wikidata
springerpub.com	scientific	wikidata
sprotspickle.com	fakenews	handcoded
spunti.com.au	scientific	wikidata
sputniknews.com	fakenews	fakenewschecker
square.umin.ac.jp	scientific	wikidata
squarespace.com	blog	handcoded
squidoo.com	blog	handcoded
sram.org	scientific	wikidata
srbc.net	usgov	usgov
src-online.ca	scientific	wikidata
srhe.ac.uk	scientific	wikidata
srhlf.free.fr	scientific	wikidata
sri.sagepub.com	scientific	wikidata
ssa.gov	usgov	usgov
ssab.gov	usgov	usgov
ssees.ucl.ac.uk	scientific	wikidata
ssh.dukejournals.org	scientific	wikidata
ssi.sagepub.com	scientific	wikidata
ssocj.jp	scientific	wikidata
sss.gov	usgov	usgov
sss.sagepub.com	scientific	wikidata
sswe.tamu.edu	scientific	wikidata
st.nu	news	wikidata
stackideas.com	blog	wikidata
stance.iweb.bsu.edu	scientific	wikidata
standard.co.uk	news	wikidata
standartnews.com	news	wikidata
staradvertiser.com	news	wikidata
starnewsonline.com	news	wikidata
startribune.com	news	wikidata
statcan.ca	scientific	wikidata
state.ca.gov	usgov	usgov
state.gov	usgov	usgov
state.nj.us	usgov	usgov
state.tn.us	usgov	usgov
state.wv.us	usgov	usgov
statnews.com	news	handcoded
stats.bls.gov	usgov	usgov
status.net	blog	wikidata
stb.dot.gov	usgov	usgov
stcatharinesstandard.ca	news	wikidata
steiner-verlag.de	scientific	wikidata
stennis.gov	usgov	usgov
sth.sagepub.com	scientific	wikidata
sti.bmj.com	scientific	wikidata
stke.sciencemag.org	scientific	wikidata
stm.sciencemag.org	scientific	wikidata
stneotscitizen.com	fakenews	fakenewschecker
store.elsevier.com	scientific	wikidata
stores.ebay.com	commercial	handcoded
storiapatriasalerno.it	scientific	wikidata
storify.com	socialmedia	wikidata
stormcloudsgathering.com	fakenews	fakenewschecker
storysouth.com	scientific	wikidata
stratcom.mil	usgov	usgov
strates.revues.org	scientific	wikidata
stratfordbeaconherald.com	news	wikidata
stripes.com	news	wikidata
stroke.ahajournals.org	scientific	wikidata
studentaid.ed.gov	usgov	usgov
studentaidhelp.ed.gov	usgov	usgov
studia-phaenomenologica.com	scientific	wikidata
studiasocjologiczne.pl	scientific	wikidata
stuppid.com	fakenews	fakenewschecker
stuttgartdailyleader.com	news	wikidata
stuttgarter-nachrichten.de	news	wikidata
stuttgarter-zeitung.de	news	wikidata
subjectpolitics.com	fakenews	fakenewschecker
subtextproject.com	blog	wikidata
sudaroli.com	news	wikidata
sudonline.sn	news	wikidata
sueddeutsche.de	news	wikidata
suedostschweiz.ch	news	wikidata
suicidepreventionlifeline.org	usgov	usgov
sumari.hr	scientific	wikidata
suntimes.com	news	wikidata
superdeporte.es	news	wikidata
superieur.deboeck.com	scientific	wikidata
supernowosci24.pl	news	wikidata
supremecourt.gov	usgov	usgov
supremecourtus.gov	usgov	usgov
supremepatriot.com	fakenews	fakenewschecker
surgicalneurologyint.com	scientific	wikidata
surplus.sc.gov	usgov	usgov
surrealscoop.com	fakenews	fakenewschecker
sut.org.uk	scientific	wikidata
swjggc.com	scientific	wikidata
swpa.gov	usgov	usgov
swtimes.com	news	wikidata
sycamorereview.com	scientific	wikidata
sydowia.at	scientific	wikidata
sydsvenskan.se	news	wikidata
sylwan.ibles.waw.pl	scientific	wikidata
synapse.koreamed.org	scientific	wikidata
synthasite.com	blog	handcoded
sysbio.oxfordjournals.org	scientific	wikidata
systematicreviewsjournal.com	scientific	wikidata
sz-online.de	news	wikidata
szf-jfs.org	scientific	wikidata
t-ad.net	scientific	wikidata
t.co	commercial	handcoded
t35.com	blog	handcoded
tafmed.org	scientific	wikidata
tagblatt.ch	news	wikidata
tageblatt.de	news	wikidata
tagesanzeiger.ch	news	wikidata
tagesspiegel.de	news	wikidata
tageswoche.ch	news	wikidata
tai2.ntu.edu.tw	scientific	wikidata
talcualdigital.com	news	wikidata
talenthouse.com	blog	wikidata
talg.acm.org	scientific	wikidata
talkingpointsmemo.com	news	handcoded
tampabay.com	news	wikidata
tandf.co.uk	scientific	wikidata
tandfonline.com	scientific	wikidata|handcoded
tanea.gr	news	wikidata
tap.sagepub.com	scientific	wikidata
tas.sagepub.com	scientific	wikidata
taylorandfrancis.com	scientific	wikidata
taz.de	news	wikidata
tbf.coe.wayne.edu	scientific	wikidata
tc.columbia.edu	scientific	wikidata
tcc.export.gov	usgov	usgov
tcp.sagepub.com	scientific	wikidata
tcr.sagepub.com	scientific	wikidata
tcrecord.org	scientific	wikidata
tdcj.state.tx.us	usgov	usgov
tde.sagepub.com	scientific	wikidata
tdg.ch	news	wikidata
teaherbmilksoaps.angelfire.com	commercial	handcoded
teamat.oxfordjournals.org	scientific	wikidata
tec.sagepub.com	scientific	wikidata
tech.snmjournals.org	scientific	wikidata
techcrunch.com	news	handcoded
techdelux.com	blog	handcoded
techdirt.com	commercial	handcoded
techinsider.io	news	handcoded
technologyreview.com	news	handcoded
technorhetoric.net	scientific	wikidata
techradar.com	news	handcoded
techreport.com	news	handcoded
techspot.com	news	handcoded
techtarget.com	news	handcoded
techvibes.com	news	handcoded
tehelka.com	news	handcoded
tehrantimes.com	news	wikidata
teknoscienze.com	scientific	wikidata
telegraaf.nl	news	wikidata
telegraph.co.uk	news	wikidata
telegraphindia.com	news	wikidata|handcoded
telegraphjournal.com	news	wikidata
telligent.com	blog	wikidata
tellusa.net	scientific	wikidata
tellusb.net	scientific	wikidata
temoignages.re	news	wikidata
tenri-u.ac.jp	scientific	wikidata
teof.uni-lj.si	scientific	wikidata
terrain.org	scientific	wikidata
terrain.revues.org	scientific	wikidata
texarkanagazette.com	news	wikidata
texas.gov	usgov	usgov
texasacademyofscience.org	scientific	wikidata
textpattern.com	blog	wikidata
tfai.vu.lt	scientific	wikidata
tfc.state.tx.us	usgov	usgov
tfj.sagepub.com	scientific	wikidata
the-dispatch.com	news	wikidata
the-japan-news.com	news	wikidata
the-sun.on.cc	news	wikidata
the.sagepub.com	scientific	wikidata
theamericanindependent.wordpress.com	fakenews	fakenewschecker
theantimedia.org	fakenews	fakenewschecker
theassc.org	scientific	wikidata
theatlantic.com	news	handcoded
theaustralian.com.au	news	wikidata
thebeaverton.com	fakenews	fakenewschecker|handcoded
theblackscholar.org	scientific	wikidata
theblaze.com	fakenews	handcoded
thebostontribune.com	fakenews	fakenewschecker
theburlingamedailynews.com	news	wikidata
thechattahoocheereview.gpc.edu	scientific	wikidata
thechronicleherald.ca	news	wikidata
thecivilian.co.nz	fakenews	handcoded
thecommononline.org	scientific	wikidata
thecommonsenseshow.com	fakenews	fakenewschecker
thecontroversialfiles.net	fakenews	fakenewschecker
thecps.org.uk	scientific	wikidata
thedailybeast.com	fakenews	fakenewschecker
thedailymash.co.uk	fakenews	fakenewschecker|handcoded
thedailysheeple.com	clickbait|fakenews	fakenewschecker|handcoded
thedailystar.net	news	wikidata
thedailywtf.com	fakenews	fakenewschecker|handcoded
theduran.com	fakenews	fakenewschecker
theepochtimes.com	news	handcoded
theeventchronicle.com	fakenews	fakenewschecker
thefederalist.com	news	handcoded
thefederalistpapers.org	fakenews	fakenewschecker
theforbiddenknowledge.com	fakenews	fakenewschecker
thefreepatriot.org	fakenews	fakenewschecker
thefreethoughtproject.com	fakenews	fakenewschecker|handcoded
thegatewaypundit.com	fakenews	fakenewschecker
theglobeandmail.com	news	wikidata|handcoded
thegospelcoalition.org	scientific	wikidata
theguardian.com	news	wikidata|handcoded
theguardian.pe.ca	news	wikidata
thehackernews.com	blog	handcoded
thehastingscenter.org	scientific	wikidata
thehill.com	news	handcoded
thehindu.com	news	handcoded
thehindubusinessline.com	news	handcoded
thehopkinsreview.com	scientific	wikidata
theiet.org	scientific	wikidata
theijhss.com	scientific	wikidata
theineptowl.com	fakenews	fakenewschecker
theinquirer.net	news	handcoded
theintercept.com	news	handcoded
thejakartapost.com	news	wikidata
thejns.org	scientific	wikidata
thejpd.org	scientific	wikidata
thekhayaban.com	scientific	wikidata
thelancet.com	scientific	wikidata
thelapine.ca	satire|fakenews	fakenewschecker|handcoded
thelastgreatstand.com	fakenews	fakenewschecker
theledger.com	news	wikidata
thelibertybeacon.com	fakenews	fakenewschecker
themadisonmisnomer.com	fakenews	fakenewschecker
themedicalroundtable.com	scientific	wikidata
themercury.com.au	news	wikidata
themindunleashed.org	fakenews	fakenewschecker
themusicaltimes.blogspot.com	scientific	wikidata
themuslimissue.wordpress.com	fakenews	fakenewschecker
thenation.com	news	handcoded
theneurologist.org	scientific	wikidata
thenewday.co.uk	news	wikidata
thenewinquiry.com	fakenews	fakenewschecker
thenews.com.pk	news	wikidata
thenewsnerd.com	fakenews	fakenewschecker|handcoded
theobserver.ca	news	wikidata
theonion.com	satire|fakenews	fakenewschecker|handcoded
theoryofcomputing.org	scientific	wikidata
theoxymoron.co.uk	fakenews	handcoded
thepatient.adisonline.com	scientific	wikidata
thepeninsulaqatar.com	news	wikidata
thepeterboroughexaminer.com	news	wikidata
theplantlist.org	scientific	wikidata
thepoke.co.uk	fakenews	fakenewschecker|handcoded
thepoliticalinsider.com	fakenews	fakenewschecker
thepress.purdue.edu	scientific	wikidata
theracketreport.com	fakenews	fakenewschecker
therealstrategy.com	fakenews	fakenewschecker
therecord.com	news	wikidata
thereporterz.com	fakenews	handcoded
therightists.com	fakenews	fakenewschecker
therundownlive.com	clickbait|fakenews	fakenewschecker|handcoded
theshovel.com.au	fakenews	fakenewschecker
theskunk.org	fakenews	fakenewschecker
thesociologicalreview.com	scientific	wikidata
thespec.com	news	wikidata
thespinejournalonline.com	scientific	wikidata
thespoof.com	satire|fakenews	fakenewschecker|handcoded
thestar.com	news	wikidata|handcoded
thestar.com.my	news	wikidata
thestarphoenix.com	news	handcoded
thestatelyharold.com	fakenews	handcoded
thesudburystar.com	news	wikidata
thesun.co.uk	news	wikidata
thetelegram.com	news	wikidata
thetimes.co.uk	news	wikidata
thetimesnews.com	news	wikidata
thetimesoftheworld.com	fakenews	fakenewschecker
thetruthdivision.com	fakenews	fakenewschecker
thetruthseeker.co.uk	fakenews	fakenewschecker
theunrealtimes.com	fakenews	fakenewschecker|handcoded
theuspatriot.com	fakenews	fakenewschecker|handcoded
thevaccinereaction.org	blog	handcoded
thevalleyreport.com	fakenews	fakenewschecker|handcoded
theverge.com	news	handcoded
thewalrus.ca	news	handcoded
thewatchtowers.com	fakenews	fakenewschecker
thewesternstar.com	news	wikidata
thewhig.com	news	wikidata
thewire.in	news	handcoded
thewrap.com	blog	handcoded
thieme-chemistry.com	scientific	wikidata
thieme-connect.com	scientific	wikidata
thieme.com	scientific	wikidata
thieme.de	scientific	wikidata
thinakaran.lk	news	wikidata
thingamablog.com	blog	wikidata
thinkingmomsrevolution.com	blog	handcoded
thirdtext.com	scientific	wikidata
thisispinball.com	scientific	wikidata
thoracic.org	scientific	wikidata
thoracicmedicine.org	scientific	wikidata
thorax.bmj.com	scientific	wikidata
thr.sagepub.com	scientific	wikidata
threatpost.com	news	handcoded
threepercenternation.com	fakenews	fakenewschecker
thuto.org	scientific	wikidata
thz.ieee.org	scientific	wikidata
tia.sagepub.com	scientific	wikidata
tidsskrift.dk	scientific	wikidata
tidsskriftet.no	scientific	wikidata
tigsource.com	news	handcoded
tih.sagepub.com	scientific	wikidata
tijd.be	news	wikidata
tim.sagepub.com	scientific	wikidata
time.com	news	handcoded
times-journal.com	news	wikidata
timesdaily.com	news	wikidata
timesofoman.com	news	wikidata
timesrecordnews.com	news	wikidata
tistory.com	blog	wikidata
tjmc.edu.cn	scientific	wikidata
tlainc.com	scientific	wikidata
tme.coe.uga.edu	scientific	wikidata
tms.org	scientific	wikidata
tmstudies.net	scientific	wikidata
tmt.sagepub.com	scientific	wikidata
tmz.com	news	handcoded
tn.gov	usgov	usgov
tnlottery.com	usgov	usgov
tnm.jp	scientific	wikidata
tnp.sg	news	wikidata
tnvacation.com	usgov	usgov
tobaccocontrol.bmj.com	scientific	wikidata
tobunken.go.jp	scientific	wikidata
tochi.acm.org	scientific	wikidata
tocl.acm.org	scientific	wikidata
tocs.acm.org	scientific	wikidata
today.com	blog	handcoded
todaydailynews.com	news	wikidata
tods.acm.org	scientific	wikidata
tokyo-np.co.jp	news	wikidata
tomccap.acm.org	scientific	wikidata
toms.acm.org	scientific	wikidata
ton.seas.upenn.edu	scientific	wikidata
tools.usps.com	usgov	usgov
top.sagepub.com	scientific	wikidata
topekasnews.com	fakenews	fakenewschecker|handcoded
topinfopost.com	fakenews	fakenewschecker
toplas.acm.org	scientific	wikidata
toprightnews.com	fakenews	fakenewschecker
torontosportsmedia.com	news	handcoded
torontosun.canoe.ca	news	wikidata
torontosun.com	news	handcoded
torreybotanical.org	scientific	wikidata
tos.org	scientific	wikidata
tosem.acm.org	scientific	wikidata
tou.sagepub.com	scientific	wikidata
toucharcade.com	news	handcoded
tourism.az.gov	usgov	usgov
townhall.com	news	handcoded
toxsci.oxfordjournals.org	scientific	wikidata
tpa.sagepub.com	scientific	wikidata
tpi.it	news	wikidata
tpj.sagepub.com	scientific	wikidata
tps.sagepub.com	scientific	wikidata
tpx.sagepub.com	scientific	wikidata
tr.instela.com	socialmedia	wikidata
tr.knteu.kiev.ua	scientific	wikidata
tra.sagepub.com	scientific	wikidata
tractionsoftware.com	blog	wikidata
trade.gov	usgov	usgov
traffic.dk	scientific	wikidata
traildailytimes.ca	news	wikidata
trans-int.org	scientific	wikidata
transacl.org	scientific	wikidata
transci.pubs.informs.org	scientific	wikidata
transcom.mil	usgov	usgov
translational-medicine.com	scientific	wikidata
translationalres.com	scientific	wikidata
transportation.ky.gov	usgov	usgov
transportation.wv.gov	usgov	usgov
travel.state.gov	usgov	usgov
travelalaska.com	usgov	usgov
traveliowa.com	usgov	usgov
travelks.com	usgov	usgov
travelnevada.com	usgov	usgov
travelok.com	usgov	usgov
traveloregon.com	usgov	usgov
travelsouthdakota.com	usgov	usgov
traveltex.com	usgov	usgov
travelwisconsin.com	usgov	usgov
tre.sagepub.com	scientific	wikidata
treas.gov	usgov	usgov
treasury.gov	usgov	usgov
treasurydirect.gov	usgov	usgov
treehugger.com	news	handcoded
trentinocorrierealpi.gelocal.it	news	wikidata
tresor.economie.gouv.fr	scientific	wikidata
trialsjournal.com	scientific	wikidata
triblive.com	news	wikidata
tricare.mil	usgov	usgov
trinj.com	scientific	wikidata
triquarterly.org	scientific	wikidata
trivium.revues.org	scientific	wikidata
trj.sagepub.com	scientific	wikidata
trn.sagepub.com	scientific	wikidata
tropicalgrasslands.asn.au	scientific	wikidata
tropicultura.org	scientific	wikidata
trouw.nl	news	wikidata
trueactivist.com	fakenews	fakenewschecker
truepundit.com	fakenews	fakenewschecker
truman.gov	usgov	usgov
trurodaily.com	news	wikidata
truth.tv	blog	handcoded
truthandaction.org	fakenews	fakenewschecker
truthfeed.com	fakenews	fakenewschecker
truthfrequencyradio.com	clickbait|fakenews	fakenewschecker|handcoded
truthinmedia.com	blog	handcoded
truthkings.com	fakenews	fakenewschecker
truthpoliticsnews.com	fakenews	fakenewschecker
ts.lemoyne.edu	scientific	wikidata
tsa-algerie.com	news	wikidata
tsa.gov	usgov	usgov
tseg.nl	scientific	wikidata
tsn.ca	news	handcoded
tsp.gov	usgov	usgov
tsup.truman.edu	scientific	wikidata
tswj.com	scientific	wikidata
tt.com	news	wikidata
ttb.gov	usgov	usgov
ttl.fi	scientific	wikidata
tts.sec.gov	usgov	usgov
ttv.com.tw	scientific	wikidata
tug.org	scientific	wikidata
tulsamedicalspa.com	commercial	handcoded
tumblr.com	blog|socialmedia	wikidata|handcoded
tuscaloosanews.com	news	wikidata
tuttosport.com	news	wikidata
tva.com	usgov	usgov
tva.gov	usgov	usgov
tva.sagepub.com	scientific	wikidata
tvn.sagepub.com	scientific	wikidata
tweetedtimes.com	commercial	handcoded
twi.gl	commercial	handcoded
twister.net.co	blog	wikidata
twitchy.com	fakenews	fakenewschecker|handcoded
twitter.com	twitter|socialmedia	wikidata|handcoded
twitterrific.com	blog	wikidata
txdmv.gov	usgov	usgov
txlottery.org	usgov	usgov
tyndale.cam.ac.uk	scientific	wikidata
typepad.com	blog	wikidata|handcoded
uaa.alaska.edu	scientific	wikidata
ualberta.ca	scientific	wikidata
uar.sagepub.com	scientific	wikidata
ub.edu	scientific	wikidata
ub.es	scientific	wikidata
ubishops.ca	scientific	wikidata
ubo.cl	scientific	wikidata
uc.pt	scientific	wikidata
uclm.es	scientific	wikidata
ucmo.edu	scientific	wikidata
uco.es	scientific	wikidata
ucowr.org	scientific	wikidata
ucoz.com	blog	wikidata
ucpressjournals.com	scientific	wikidata
udall.gov	usgov	usgov
udppc.asso.fr	scientific	wikidata
uel.ac.uk	scientific	wikidata
uex.sagepub.com	scientific	wikidata
ufaw.org.uk	scientific	wikidata
ufj.ho.ua	scientific	wikidata
ufn.ru	scientific	wikidata
uga.edu	scientific	wikidata
ugeskriftet.dk	scientific	wikidata
uhpress.hawaii.edu	scientific	wikidata
uia.no	scientific	wikidata
uiweb.uidaho.edu	scientific	wikidata
ujp.bitp.kiev.ua	scientific	wikidata
uk.sagepub.com	scientific	wikidata
um.es	scientific	wikidata
umaine.edu	scientific	wikidata
umanitoba.ca	news	wikidata
umass.edu	scientific	wikidata
umes.edu	scientific	wikidata
umich.edu	scientific	wikidata
unav.es	scientific	wikidata
unclesamsmisguidedchildren.com	fakenews	fakenewschecker
unco.edu	scientific	wikidata
unconfirmedsources.com	clickbait|fakenews	fakenewschecker|handcoded
uncpress.unc.edu	scientific	wikidata
undergroundworldnews.com	fakenews	fakenewschecker
uniblogs.org	blog	handcoded
unionesarda.it	news	wikidata
unioviedo.es	scientific	wikidata
unisa.ac.za	scientific	wikidata
unita.it	news	wikidata
unitedmediapublishing.com	fakenews	handcoded
univ-orleans.fr	scientific	wikidata
universite.deboeck.com	scientific	wikidata
universum.utalca.cl	scientific	wikidata
uno.edu	scientific	wikidata
uottawa.scholarsportal.info	scientific	wikidata
upd.sagepub.com	scientific	wikidata
upi.com	news	handcoded
upress.umn.edu	scientific	wikidata
upworthy.com	blog	handcoded
urbanavis.dk	news	wikidata
urbani-izziv.uirs.si	scientific	wikidata
urbanvine.co	blog	handcoded
us-cert.gov	usgov	usgov
us.army.mil	usgov	usgov
us.blastingnews.com	fakenews	fakenewschecker
us.geosnews.com	news	handcoded
usa.gov	usgov	usgov
usace.army.mil	usgov	usgov
usadf.gov	usgov	usgov
usahitman.com	fakenews	fakenewschecker
usaid.gov	usgov	usgov
usajobs.gov	usgov	usgov
usanewsflash.com	fakenews	fakenewschecker
usanewsinsider.com	fakenews	fakenewschecker
usasupreme.com	fakenews	fakenewschecker|handcoded
usatoday.com	news	wikidata|handcoded
usbg.gov	usgov	usgov
usbr.gov	usgov	usgov
usc.es	scientific	wikidata
usccr.gov	usgov	usgov
uscfc.uscourts.gov	usgov	usgov
uscg.mil	usgov	usgov
uscgboating.org	usgov	usgov
uscirf.gov	usgov	usgov
uscis.gov	usgov	usgov
uscourts.cavc.gov	usgov	usgov
uscourts.gov	usgov	usgov
uscp.gov	usgov	usgov
usda.gov	usgov|scientific	usgov|wikidata
usdoj.gov	usgov	usgov
usembassy.gov	usgov	usgov
usgs.gov	usgov	usgov
ushealthyadvisor.com	fakenews	fakenewschecker
ushmm.org	usgov	usgov
usi.edu	scientific	wikidata
usich.gov	usgov	usgov
usip.org	usgov	usgov
usitc.gov	usgov	usgov
usj.sagepub.com	scientific	wikidata
usma.edu	usgov	usgov
usmagazine.com	news	handcoded
usmarshals.gov	usgov	usgov
usmc.mil	usgov	usgov
usmint.gov	usgov	usgov
usnews.com	news	handcoded
usnwc.edu	scientific	wikidata
uspoliticslive.com	fakenews	fakenewschecker
usps.com	usgov	usgov
uspto.gov	usgov	usgov
usqr.utsnyc.edu	scientific	wikidata
ussc.gov	usgov	usgov
ustaxcourt.gov	usgov	usgov
ustda.gov	usgov	usgov
ustr.gov	usgov	usgov
usuhs.edu	usgov	usgov
usuhs.mil	usgov	usgov
usun.state.gov	usgov	usgov
usuncut.com	fakenews	fakenewschecker|handcoded
usunnewyork.usmission.gov	usgov	usgov
usvidoj.codemeta.com	usgov	usgov
ut.edu	scientific	wikidata
ut.ee	scientific	wikidata
utah.gov	usgov	usgov
uthayan.com	news	wikidata
utoronto.ca	scientific	wikidata
utpjournals.com	scientific	wikidata
utpress.utexas.edu	scientific	wikidata
utsa.edu	scientific	wikidata
utulsa.edu	scientific	wikidata
uwm.edu.pl	scientific	wikidata
uwpress.wisc.edu	scientific	wikidata
v-r.de	scientific	wikidata
va.gov	usgov	usgov
vaccineimpact.com	blog	handcoded
vactruth.com	blog	handcoded
vaildaily.com	news	wikidata
vailmountaineer.com	news	wikidata
valottery.com	usgov	usgov
vancouversun.com	news	wikidata
vanguardia.com	news	wikidata
variety.com	news	handcoded
vasarhelyihirlap.ro	news	wikidata
vaw.sagepub.com	scientific	wikidata
vaxxed.com	blog	handcoded
vaxxedthemovie.com	commercial	handcoded
vba.va.gov	usgov	usgov
vcj.sagepub.com	scientific	wikidata
vcps.org	scientific	wikidata
vecer.mk	news	wikidata
vedomosti.ru	news	wikidata
vef.gov	usgov	usgov
venturebeat.com	news	handcoded
verlag-hanshuber.com	scientific	wikidata
vermont.gov	usgov	usgov
versita.com	scientific	wikidata
vertpaleo.org	scientific	wikidata
ves.sagepub.com	scientific	wikidata
vessel.com	videos	wikidata
vestoj.com	scientific	wikidata
vet.sagepub.com	scientific	wikidata
veteranstoday.com	clickbait|fakenews	fakenewschecker|handcoded
veterinaryrecord.bvapublications.com	scientific	wikidata
vetsci.org	scientific	wikidata
vevo.com	videos	wikidata
vg.no	news	wikidata
vi.gov	usgov	usgov
vice.com	news	handcoded
vid.staged.com	commercial	handcoded
video.foxnews.com	news	handcoded
video214.com	commercial	handcoded
viensuhoc.vass.gov.vn	scientific	wikidata
vigilantcitizen.com	fakenews	fakenewschecker
viid.me	commercial	handcoded
villanova.edu	scientific	wikidata
vimeo.com	socialmedia|videos	wikidata|handcoded
vine.co	socialmedia	handcoded
vip.sos.nd.gov	usgov	usgov
virakesari.lk	news	wikidata
viralliberty.com	fakenews	fakenewschecker
viralnova.com	news	handcoded
virginia.gov	usgov	usgov
virginia.org	usgov	usgov
virologyj.com	scientific	wikidata
visionlaunch.com	blog	handcoded
visir.is	news	wikidata
visit-massachusetts.com	usgov	usgov
visit-palau.com	usgov	usgov
visit-vermont.com	usgov	usgov
visitdelaware.com	usgov	usgov
visitflorida.com	usgov	usgov
visitguam.com	usgov	usgov
visitidaho.org	usgov	usgov
visitindiana.com	usgov	usgov
visitmaine.com	usgov	usgov
visitmaryland.org	usgov	usgov
visitmississippi.org	usgov	usgov
visitmo.com	usgov	usgov
visitmt.com	usgov	usgov
visitnc.com	usgov	usgov
visitnebraska.com	usgov	usgov
visitnh.gov	usgov	usgov
visitnj.org	usgov	usgov
visitpa.com	usgov	usgov
visitrhodeisland.com	usgov	usgov
visitthecapitol.gov	usgov	usgov
visitusvi.com	usgov	usgov
visitutah.com	usgov	usgov
visnik.knteu.kiev.ua	scientific	wikidata
vitweet.com	blog	handcoded
vivelohoy.com	news	wikidata
viviti.com	blog	handcoded
vivote.gov	usgov	usgov
vjesnik.hr	news	wikidata
vk.com	socialmedia	wikidata
vk.se	news	wikidata
vkrugudruzei.ru	socialmedia	wikidata
vmj.sagepub.com	scientific	wikidata
voce.com.ve	news	wikidata
vocedimantova.it	news	wikidata
voix-oranie.com	news	wikidata
volkskrant.nl	news	wikidata
volume.revues.org	scientific	wikidata
voppsy.ru	scientific	wikidata
votecnmi.gov.mp	usgov	usgov
votingmatters.org.uk	scientific	wikidata
vox.com	blog	handcoded
vqronline.org	scientific	wikidata
wakingupwisconsin.com	clickbait|fakenews	handcoded
walesonline.co.uk	news	wikidata
walker.wi.gov	usgov	usgov
walkingtimes.com	fakenews	handcoded
walottery.com	usgov	usgov
wapa.gov	usgov	usgov
warontherocks.com	blog	handcoded
warship.org	scientific	wikidata
washingtonexaminer.com	news|fakenews	fakenewschecker|wikidata
washingtonpost.com	news	wikidata|handcoded
washingtontimes.com	news	handcoded
water.usgs.gov	usgov	usgov
waterbirds.org	scientific	wikidata
waterfordwhispersnews.com	fakenews	fakenewschecker|handcoded
waz.de	news	wikidata
wcx.sagepub.com	scientific	wikidata
wdb.ugr.es	scientific	wikidata
wdcrobcolp01.ed.gov	usgov	usgov
wearechange.org	fakenews	fakenewschecker
weaselzippers.us	blog	handcoded
weather.gov	usgov	usgov
web.archive.org	news|socialmedia|scientific	wikidata
web.ita.doc.gov	usgov	usgov
web.novus.no	scientific	wikidata
web.uvic.ca	scientific	wikidata
web1.iseas.edu.sg	scientific	wikidata
webapp6.rrz.uni-hamburg.de	scientific	wikidata
webcitation.org	scientific	wikidata
webdaily.com	fakenews	fakenewschecker
webmd.com	blog	handcoded
webnode.com	blog	wikidata|handcoded
webnodes.com	blog	wikidata
webs.com	blog	handcoded
website.com	fakenews	handcoded
weebly.com	blog	handcoded
weeklystandard.com	news	handcoded
weeklyworldnews.com	satire|fakenews	fakenewschecker|handcoded
weibo.com	socialmedia	wikidata
well.blogs.nytimes.com	news	handcoded
welt.de	news	wikidata
wenweipo.com	news	wikidata
wes.sagepub.com	scientific	wikidata
westernfolklore.org	scientific	wikidata
westernjournalism.com	fakenews	fakenewschecker
wetpaint.com	blog	handcoded
whatdoesitmean.com	fakenews	fakenewschecker
whatreallyhappened.com	fakenews	fakenewschecker
whitehorsestar.com	news	wikidata
whitehouse.gov	usgov	usgov
whitepower.com	fakenews	fakenewschecker
who.eop.gov	usgov	usgov
who.int	scientific	wikidata
whowhatwhy.org	fakenews	fakenewschecker
whs.mil	usgov	usgov
wichita.edu	scientific	wikidata
wideawakeamerica.com	clickbait|fakenews	handcoded
wih.sagepub.com	scientific	wikidata
wijoumed.org	scientific	wikidata
wikidot.com	blog	handcoded
wikipedia.com	blog	handcoded
wikispaces.com	blog	handcoded
wiley-vch.de	scientific	wikidata
wiley.com	scientific	wikidata|handcoded
wileyonlinelibrary.com	scientific	wikidata
wilottery.com	usgov	usgov
wilsoncenter.org	usgov	usgov
windsorstar.com	news	wikidata|handcoded
winetitles.com.au	scientific	wikidata
winningdemocrats.com	fakenews	fakenewschecker|handcoded
winnipegfreepress.com	news	wikidata|handcoded
winnipegsun.com	news	wikidata
winusvilottery.com	usgov	usgov
wipfandstock.com	scientific	wikidata
wired.com	news	handcoded
wireless.fcc.gov	usgov	usgov
wires.wiley.com	scientific	wikidata
wirtschaftsdienst.eu	scientific	wikidata
wisconsin.gov	usgov	usgov
witness.blackmountaininstitute.org	scientific	wikidata
witscience.org	fakenews	fakenewschecker|handcoded
wix.com	blog	handcoded
wiz.pl	scientific	wikidata
wjgnet.com	scientific	wikidata
wjn.sagepub.com	scientific	wikidata
wjoonline.org	scientific	wikidata
wmr.sagepub.com	scientific	wikidata
wnd.com	fakenews	fakenewschecker|handcoded
wom.sagepub.com	scientific	wikidata
womansartjournal.org	scientific	wikidata
womenshealthandfitness.com.au	news	handcoded
wonkie.com	fakenews	fakenewschecker
woodstocksentinelreview.com	news	wikidata
wordpress.com	blog	wikidata|handcoded
wordpress.org	blog	wikidata
world.einnews.com	blog	handcoded
worldaffairsjournal.org	scientific	wikidata
worldneurosurgery.org	scientific	wikidata
worldnewsdailyreport.com	satire|fakenews	fakenewschecker|handcoded
worldoil.com	scientific	wikidata
worldpolicy.org	scientific	wikidata
worldscientific.com	scientific	wikidata
worldscinet.com	scientific	wikidata
worldtruth.tv	clickbait|fakenews	fakenewschecker|handcoded
wox.sagepub.com	scientific	wikidata
wr.de	news	wikidata
wrc.org.za	scientific	wikidata
wsj.com	news	handcoded
wt.diecezja.tarnow.pl	scientific	wikidata
wv.gov	usgov	usgov
wvdoc.com	usgov	usgov
wvlottery.com	usgov	usgov
wvtourism.com	usgov	usgov
wvupressonline.com	scientific	wikidata
ww1.now-you-can-have.com	commercial	handcoded
ww2.ceepur.org	usgov	usgov
ww2.wapa.gov	usgov	usgov
ww3.freddiemac.com	usgov	usgov
www-english.tamu.edu	scientific	wikidata
www-gewi.kfunigraz.ac.at	scientific	wikidata
www-odi.nhtsa.dot.gov	usgov	usgov
www1.montpellier.inra.fr	scientific	wikidata
www1.va.gov	usgov	usgov
www2.ametsoc.org	scientific	wikidata
www2.archivists.org	scientific	wikidata
www2.ed.gov	usgov	usgov
www2.filg.uj.edu.pl	scientific	wikidata
www2.ihp.sinica.edu.tw	scientific	wikidata
www2.illinois.gov	usgov	usgov
www2.johnson.cornell.edu	scientific	wikidata
www2.pr.gov	usgov	usgov
www2.va.gov	usgov	usgov
www2.washjeff.edu	scientific	wikidata
www3.interscience.wiley.com	scientific	wikidata
www3.nd.edu	scientific	wikidata
www3.wooster.edu	scientific	wikidata
wwwmath.uni-muenster.de	scientific	wikidata
wyo.gov	usgov	usgov
wyolotto.com	usgov	usgov
wyomingtourism.org	usgov	usgov
wz.de	news	wikidata
wzonline.de	news	wikidata
xanga.com	blog	handcoded
xing.com	socialmedia	wikidata
xjdaily.com	news	wikidata
xula.edu	scientific	wikidata
xxx.sagepub.com	scientific	wikidata
yachtingmagazine.com	scientific	wikidata
yahoo.com	news	handcoded
yaklass.ru	socialmedia	wikidata
yale.edu	scientific	wikidata
yaleeconomicreview.org	scientific	wikidata
yalejournal.org	scientific	wikidata
yalescientific.org	scientific	wikidata
yas.sagepub.com	scientific	wikidata
yec.sagepub.com	scientific	wikidata
yedioth.co.il	news	wikidata
yelp.com	socialmedia	wikidata
yesimright.com	fakenews	fakenewschecker
yomiuri.co.jp	news	wikidata
youaresimplyradiant.com	commercial	handcoded
yournewswire.com	fakenews	fakenewschecker
youtube.com	socialmedia|videos	wikidata|handcoded
yumasun.com	news	wikidata
yurtgazetesi.com.tr	news	wikidata
z-phys-chem.de	scientific	wikidata
zaman.com.tr	news	wikidata
zavoddbk.org	scientific	wikidata
zaytung.com	fakenews	handcoded
zdnet.com	blog	handcoded
zerohedge.com	fakenews	fakenewschecker|handcoded
zerotothree.org	scientific	wikidata
zeus.fltr.ucl.ac.be	scientific	wikidata
zgw-online.de	scientific	wikidata
zimbio.com	blog	handcoded
zizekstudies.org	scientific	wikidata
znaturforsch.com	scientific	wikidata
zookeys.pensoft.net	scientific	wikidata
zoologischemededelingen.nl	scientific	wikidata
zootfeed.com	fakenews	fakenewschecker
zsf.jcu.cz	scientific	wikidata
zsm.mwn.de	scientific	wikidata
zssa.co.za	scientific	wikidata
zygonjournal.org	scientific	wikidata
